SECCID,Seccion,Circuito,Electores 2015,Posicion 2015,Electores 2017,Posicion 2017,Variacion puesto,Variacion electores,Crec
14,RIO CUARTO,RIO CUARTO,77167,1,76969,1,0,-198,"-0,26%"
7,GRAL SAN MARTIN,VILLA MARIA,70985,2,72455,2,0,1470,"2,07%"
13,PUNILLA,VILLA CARLOS PAZ,54764,3,56431,3,0,1667,"3,04%"
22,SANTA MARIA,ALTA GRACIA,41867,5,43769,4,1,1902,"4,54%"
24,TERCERO ARRIBA,RIO TERCERO,41933,4,42845,5,-1,912,"2,17%"
3,CAPITAL,VILLA AZALAIS,31065,6,31918,6,0,853,"2,75%"
1,UNION,BELL VILLE,30587,7,31325,7,0,738,"2,41%"
14,RIO CUARTO,BANDA NORTE,30030,8,30777,8,0,747,"2,49%"
4,COLON,VILLA ALLENDE,28954,9,30499,9,0,1545,"5,34%"
4,COLON,JESUS MARIA,28407,10,29710,10,0,1303,"4,59%"
21,SAN JUSTO,SAN FRANCISCO SECC. SUR,27763,11,28395,11,0,632,"2,28%"
20,SAN JAVIER,DOLORES,27232,12,28139,12,0,907,"3,33%"
21,SAN JUSTO,SAN FRANCISCO SECC. NORTE,27103,13,28054,13,0,951,"3,51%"
3,CAPITAL,JOSE IGNACIO DIAZ,25343,16,26913,14,2,1570,"6,20%"
3,CAPITAL,VILLA EL LIBERTADOR,25906,14,26710,15,-1,804,"3,10%"
14,RIO CUARTO,PUEBLO ALBERDI,25649,15,26548,16,-1,899,"3,51%"
5,CRUZ DEL EJE,CRUZ DEL EJE,25016,17,26084,17,0,1068,"4,27%"
10,MARCOS JUAREZ,MARCOS JUAREZ,23149,19,23653,18,1,504,"2,18%"
3,CAPITAL,ALTO ALBERDI,23149,18,23555,19,-1,406,"1,75%"
3,CAPITAL,COLON,22939,20,22935,20,0,-4,"-0,02%"
3,CAPITAL,ALTA CORDOBA,22648,21,22752,21,0,104,"0,46%"
3,CAPITAL,OBSERVATORIO,21058,22,21121,22,0,63,"0,30%"
3,CAPITAL,NUEVA CORDOBA,20287,23,21029,23,0,742,"3,66%"
3,CAPITAL,SECCIONAL TERCERA,19980,24,20676,24,0,696,"3,48%"
21,SAN JUSTO,ARROYITO,19673,25,20379,25,0,706,"3,59%"
3,CAPITAL,JOSE HERNANDEZ,19645,26,20222,26,0,577,"2,94%"
3,CAPITAL,PUEYRREDON,19575,27,19927,27,0,352,"1,80%"
13,PUNILLA,COSQUIN,19042,28,19887,28,0,845,"4,44%"
4,COLON,RIO CEBALLOS,18297,30,19465,29,1,1168,"6,38%"
8,ISCHILIN,DEAN FUNES,18352,29,19296,30,-1,944,"5,14%"
3,CAPITAL,PARQUE LICEO,17986,32,18982,31,1,996,"5,54%"
4,COLON,CALERA,17439,36,18809,32,4,1370,"7,86%"
7,GRAL SAN MARTIN,VILLA NUEVA,17530,35,18740,33,2,1210,"6,90%"
3,CAPITAL,EMPALME,17670,34,18384,34,0,714,"4,04%"
18,ROQUE SAENZ PEÑA,LABOULAYE,18058,31,18335,35,-4,277,"1,53%"
3,CAPITAL,ARGUELLO NORTE,17290,40,18293,36,4,1003,"5,80%"
3,CAPITAL,BELLA VISTA,17380,37,18191,37,0,811,"4,67%"
17,RIO SEGUNDO,RIO SEGUNDO,17700,33,18052,38,-5,352,"1,99%"
4,COLON,UNQUILLO,16893,42,18018,39,3,1125,"6,66%"
3,CAPITAL,PUEBLO LAS FLORES,17256,41,17963,40,1,707,"4,10%"
3,CAPITAL,SANTA ANA,17339,38,17627,41,-3,288,"1,66%"
3,CAPITAL,PATRICIOS,17310,39,17543,42,-3,233,"1,35%"
4,COLON,COLONIA CAROYA,16651,44,17415,43,1,764,"4,59%"
3,CAPITAL,AYACUCHO,16822,43,17047,44,-1,225,"1,34%"
21,SAN JUSTO,MORTEROS,15829,47,16673,45,2,844,"5,33%"
3,CAPITAL,MARQUES DE SOBREMONTE,16154,45,16631,46,-1,477,"2,95%"
3,CAPITAL,LOS PLATANOS,15734,49,16250,47,2,516,"3,28%"
3,CAPITAL,SECCIONAL PRIMERA,15788,48,16095,48,0,307,"1,94%"
3,CAPITAL,RESIDENCIAL SAN ROQUE,14962,52,16007,49,3,1045,"6,98%"
3,CAPITAL,VILLA REVOL,15600,50,15815,50,0,215,"1,38%"
3,CAPITAL,SAN VICENTE,15859,46,15742,51,-5,-117,"-0,74%"
3,CAPITAL,SAN MARTIN,15226,51,15282,52,-1,56,"0,37%"
21,SAN JUSTO,LAS VARILLAS,14687,54,14980,53,1,293,"1,99%"
3,CAPITAL,LAS PALMAS,14810,53,14249,54,-1,-561,"-3,79%"
3,CAPITAL,LOS PARAISOS,13942,55,14098,55,0,156,"1,12%"
13,PUNILLA,LA FALDA,13848,56,14079,56,0,231,"1,67%"
3,CAPITAL,ALTAMIRA,13676,58,13933,57,1,257,"1,88%"
3,CAPITAL,GENERAL BUSTOS,13838,57,13927,58,-1,89,"0,64%"
3,CAPITAL,PARQUE REPUBLICA,12985,60,13858,59,1,873,"6,72%"
4,COLON,CALERA CENTRAL,12301,65,13522,60,5,1221,"9,93%"
17,RIO SEGUNDO,VILLA DEL ROSARIO,13005,59,13476,61,-2,471,"3,62%"
4,COLON,MALVINAS ARGENTINAS,11928,71,13138,62,9,1210,"10,14%"
17,RIO SEGUNDO,PILAR,12441,63,13127,63,0,686,"5,51%"
3,CAPITAL,LOS NARANJOS,12732,61,13002,64,-3,270,"2,12%"
3,CAPITAL,ESTACION FLORES,12118,69,12899,65,4,781,"6,44%"
3,CAPITAL,PANAMERICANO,12300,66,12869,66,0,569,"4,63%"
3,CAPITAL,MATIENZO,12454,62,12833,67,-5,379,"3,04%"
3,CAPITAL,SANTA ISABEL,12409,64,12620,68,-4,211,"1,70%"
2,CALAMUCHITA,SANTA ROSA,11640,73,12509,69,4,869,"7,47%"
3,CAPITAL,PARQUE CAPITAL,12249,67,12502,70,-3,253,"2,07%"
17,RIO SEGUNDO,ONCATIVO,11976,70,12193,71,-1,217,"1,81%"
3,CAPITAL,CIUDADELA,12227,68,12183,72,-4,-44,"-0,36%"
3,CAPITAL,GRAL PAZ,11792,72,12107,73,-1,315,"2,67%"
4,COLON,SALDAN,10787,77,12096,74,3,1309,"12,13%"
4,COLON,MENDIOLAZA,9937,84,11529,75,9,1592,"16,02%"
3,CAPITAL,LOS CERVECEROS,10415,80,11415,76,4,1000,"9,60%"
4,COLON,JUAREZ CELMAN,9863,86,11360,77,9,1497,"15,18%"
24,TERCERO ARRIBA,OLIVA,11264,74,11354,78,-4,90,"0,80%"
3,CAPITAL,VILLA GRAL URQUIZA,11004,75,11327,79,-4,323,"2,94%"
3,CAPITAL,MALDONADO,10703,78,11243,80,-2,540,"5,05%"
9,JUAREZ CELMAN,LA CARLOTA,10962,76,11183,81,-5,221,"2,02%"
3,CAPITAL,ITUZAINGO,10548,79,11101,82,-3,553,"5,24%"
13,PUNILLA,CAPILLA DEL MONTE,10340,82,10721,83,-1,381,"3,68%"
24,TERCERO ARRIBA,ALMAFUERTE,10335,83,10624,84,-1,289,"2,80%"
9,JUAREZ CELMAN,CABRERA,10363,81,10534,85,-4,171,"1,65%"
3,CAPITAL,PARQUE HORIZONTE,9858,87,10449,86,1,591,"6,00%"
15,RIO PRIMERO,MONTE CRISTO,9441,90,10150,87,3,709,"7,51%"
24,TERCERO ARRIBA,HERNANDO,9882,85,10077,88,-3,195,"1,97%"
9,JUAREZ CELMAN,DEHEZA,9509,89,9869,89,0,360,"3,79%"
3,CAPITAL,COFICO,9141,93,9791,90,3,650,"7,11%"
4,COLON,SALSIPUEDES,8733,98,9743,91,7,1010,"11,57%"
3,CAPITAL,VILLA CENTENARIO,9704,88,9704,92,-4,0,"0,00%"
3,CAPITAL,LOS BOULEVARES,9028,96,9437,93,3,409,"4,53%"
10,MARCOS JUAREZ,LEONES,9334,91,9409,94,-3,75,"0,80%"
14,RIO CUARTO,VICUÑA MACKENNA,9141,94,9389,95,-1,248,"2,71%"
3,CAPITAL,LEANDRO N. ALEM,9241,92,9268,96,-4,27,"0,29%"
3,CAPITAL,POETA LUGONES,9100,95,9246,97,-2,146,"1,60%"
3,CAPITAL,AVELLANEDA,8703,99,9171,98,1,468,"5,38%"
10,MARCOS JUAREZ,CORRAL DE BUSTOS,8991,97,8971,99,-2,-20,"-0,22%"
19,SAN ALBERTO,MINA CLAVERO,8252,102,8822,100,2,570,"6,91%"
21,SAN JUSTO,BRINKMANN,8482,100,8759,101,-1,277,"3,27%"
13,PUNILLA,SANTA MARIA,8095,105,8666,102,3,571,"7,05%"
3,CAPITAL,VILLA LOS PINOS,8417,101,8468,103,-2,51,"0,61%"
3,CAPITAL,LOS ROBLES,7350,117,8340,104,13,990,"13,47%"
2,CALAMUCHITA,VILLA GENERAL BELGRANO,7501,114,8272,105,9,771,"10,28%"
3,CAPITAL,JORGE NEWBERY,8247,103,8251,106,-3,4,"0,05%"
14,RIO CUARTO,MOLDES,8120,104,8195,107,-3,75,"0,92%"
3,CAPITAL,YAPEYU,7902,108,8173,108,0,271,"3,43%"
3,CAPITAL,URCA,8063,106,8049,109,-3,-14,"-0,17%"
25,TOTORAL,VILLA DEL TOTORAL,7756,110,8031,110,0,275,"3,55%"
3,CAPITAL,LAS MARGARITAS,7968,107,8009,111,-4,41,"0,51%"
3,CAPITAL,NUEVA ITALIA,7815,109,7940,112,-3,125,"1,60%"
1,UNION,CANALS,7708,111,7714,113,-2,6,"0,08%"
3,CAPITAL,VILLA 9 DE JULIO,7248,120,7703,114,6,455,"6,28%"
1,UNION,POSSE,7503,113,7678,115,-2,175,"2,33%"
5,CRUZ DEL EJE,SOTO,7152,121,7667,116,5,515,"7,20%"
3,CAPITAL,YOFRE,7489,115,7591,117,-2,102,"1,36%"
6,GENERAL ROCA,HUINCA RENANCO,7600,112,7565,118,-6,-35,"-0,46%"
14,RIO CUARTO,SAMPACHO,7443,116,7525,119,-3,82,"1,10%"
15,RIO PRIMERO,VILLA SANTA ROSA,7267,119,7465,120,-1,198,"2,72%"
2,CALAMUCHITA,EMBALSE,7104,122,7463,121,1,359,"5,05%"
3,CAPITAL,JUNIORS,7043,123,7449,122,1,406,"5,76%"
22,SANTA MARIA,MALAGUEÑO,6972,125,7295,123,2,323,"4,63%"
3,CAPITAL,ARGUELLO,6656,131,7191,124,7,535,"8,04%"
3,CAPITAL,ARGUELLO PRIMERO,7316,118,7171,125,-7,-145,"-1,98%"
13,PUNILLA,LA CUMBRE,7039,124,7126,126,-2,87,"1,24%"
3,CAPITAL,COMERCIAL,6881,127,7055,127,0,174,"2,53%"
14,RIO CUARTO,LAS HIGUERAS,6209,141,6992,128,13,783,"12,61%"
15,RIO PRIMERO,RIO PRIMERO,6644,132,6965,129,3,321,"4,83%"
17,RIO SEGUNDO,LAGUNA LARGA,6824,128,6806,130,-2,-18,"-0,26%"
3,CAPITAL,QUEBRADA LAS ROSAS,6639,133,6802,131,2,163,"2,46%"
3,CAPITAL,GUIÑAZU,6638,134,6787,132,2,149,"2,24%"
3,CAPITAL,GRANJA DE FUNES,6703,130,6771,133,-3,68,"1,01%"
3,CAPITAL,DON BOSCO,6708,129,6739,134,-5,31,"0,46%"
3,CAPITAL,CERRO NORTE,6463,137,6648,135,2,185,"2,86%"
3,CAPITAL,CERRO DE LAS ROSAS,6883,126,6594,136,-10,-289,"-4,20%"
1,UNION,MONTE MAIZ,6600,135,6525,137,-2,-75,"-1,14%"
13,PUNILLA,TANTI,5927,144,6518,138,6,591,"9,97%"
10,MARCOS JUAREZ,ARIAS,6533,136,6509,139,-3,-24,"-0,37%"
14,RIO CUARTO,ADELIA MARIA,6341,139,6453,140,-1,112,"1,77%"
14,RIO CUARTO,BERROTARAN,6347,138,6393,141,-3,46,"0,72%"
10,MARCOS JUAREZ,CRUZ ALTA,6295,140,6275,142,-2,-20,"-0,32%"
4,COLON,COLONIA TIROLESA,5315,160,6265,143,17,950,"17,87%"
3,CAPITAL,SAN JORGE,6024,143,6206,144,-1,182,"3,02%"
13,PUNILLA,BIALET MASSE,5554,154,6163,145,9,609,"10,97%"
21,SAN JUSTO,FREYRE,6152,142,6151,146,-4,-1,"-0,02%"
3,CAPITAL,SECCIONAL SEGUNDA,5693,147,6145,147,0,452,"7,94%"
13,PUNILLA,HUERTA GRANDE,5650,149,6037,148,1,387,"6,85%"
19,SAN ALBERTO,BROCHERO,5650,148,5979,149,-1,329,"5,82%"
22,SANTA MARIA,DESPEÑADEROS,5604,151,5951,150,1,347,"6,19%"
3,CAPITAL,ESCOBAR,5873,146,5916,151,-5,43,"0,73%"
3,CAPITAL,VILLA CABRERA,5899,145,5859,152,-7,-40,"-0,68%"
3,CAPITAL,CARCANO,5497,157,5820,153,4,323,"5,88%"
17,RIO SEGUNDO,LUQUE,5555,153,5751,154,-1,196,"3,53%"
21,SAN JUSTO,BALNEARIA,5618,150,5721,155,-5,103,"1,83%"
13,PUNILLA,VALLE HERMOSO,5416,159,5671,156,3,255,"4,71%"
10,MARCOS JUAREZ,MONTE BUEY,5441,158,5623,157,1,182,"3,34%"
21,SAN JUSTO,DEVOTO,5509,155,5611,158,-3,102,"1,85%"
17,RIO SEGUNDO,POZO DEL MOLLE,5578,152,5585,159,-7,7,"0,13%"
3,CAPITAL,VICOR,4888,174,5551,160,14,663,"13,56%"
14,RIO CUARTO,ALCIRA,5508,156,5527,161,-5,19,"0,34%"
13,PUNILLA,VILLA GIARDINO,4997,169,5428,162,7,431,"8,63%"
3,CAPITAL,SANTA CECILIA,5146,166,5406,163,3,260,"5,05%"
14,RIO CUARTO,HOLMBERG,4707,181,5333,164,17,626,"13,30%"
3,CAPITAL,COLONIA LOLA,5178,165,5322,165,0,144,"2,78%"
1,UNION,LABORDE,5210,164,5244,166,-2,34,"0,65%"
3,CAPITAL,ALTO GRAL PAZ,5305,162,5240,167,-5,-65,"-1,23%"
9,JUAREZ CELMAN,ALEJANDRO,5040,168,5183,168,0,143,"2,84%"
21,SAN JUSTO,PORTEÑA,4967,171,5155,169,2,188,"3,78%"
3,CAPITAL,VILLA BELGRANO,5310,161,5134,170,-9,-176,"-3,31%"
18,ROQUE SAENZ PEÑA,LEVALLE,5066,167,5116,171,-4,50,"0,99%"
3,CAPITAL,COLINAS DEL SUR,4756,180,5111,172,8,355,"7,46%"
16,RIO SECO,VILLA DE MARIA,4823,176,5088,173,3,265,"5,49%"
3,CAPITAL,CABILDO,4776,178,5049,174,4,273,"5,72%"
3,CAPITAL,PROVIDENCIA,4903,173,5033,175,-2,130,"2,65%"
3,CAPITAL,FERREYRA,4774,179,5033,176,3,259,"5,43%"
6,GENERAL ROCA,VILLA HUIDOBRO,4969,170,5029,177,-7,60,"1,21%"
3,CAPITAL,ARGUELLO SEGUNDO,4650,182,5006,178,4,356,"7,66%"
3,CAPITAL,LA FRANCE,4942,172,4987,179,-7,45,"0,91%"
9,JUAREZ CELMAN,UCACHA,4849,175,4951,180,-5,102,"2,10%"
24,TERCERO ARRIBA,TANCACHA,4818,177,4912,181,-4,94,"1,95%"
20,SAN JAVIER,LAS ROSAS,4364,191,4780,182,9,416,"9,53%"
22,SANTA MARIA,ANIZACATE,4043,201,4759,183,18,716,"17,71%"
13,PUNILLA,SAN ANTONIO DE ARREDONDO,4474,188,4750,184,4,276,"6,17%"
22,SANTA MARIA,TOLEDO,4299,193,4742,185,8,443,"10,30%"
3,CAPITAL,VALLE ESCONDIDO,3960,202,4742,186,16,782,"19,75%"
3,CAPITAL,AERONAUTICO,4503,186,4728,187,-1,225,"5,00%"
3,CAPITAL,RENACIMIENTO,4482,187,4715,188,-1,233,"5,20%"
19,SAN ALBERTO,VILLA SARMIENTO,4457,190,4694,189,1,237,"5,32%"
3,CAPITAL,VILLA CORNU,5269,163,4679,190,-27,-590,"-11,20%"
3,CAPITAL,MERCANTIL,3606,208,4663,191,17,1057,"29,31%"
3,CAPITAL,INAUDI,4300,192,4652,192,0,352,"8,19%"
3,CAPITAL,CORONEL OLMEDO,4524,185,4632,193,-8,108,"2,39%"
24,TERCERO ARRIBA,JAMES CRAIK,4581,183,4627,194,-11,46,"1,00%"
26,TULUMBA,LA DORMIDA,4459,189,4606,195,-6,147,"3,30%"
19,SAN ALBERTO,SAN PEDRO,4175,197,4588,196,1,413,"9,89%"
1,UNION,NOETINGER,4558,184,4566,197,-13,8,"0,18%"
24,TERCERO ARRIBA,LAS PERDICES,4278,195,4401,198,-3,123,"2,88%"
6,GENERAL ROCA,JOVITA,4281,194,4398,199,-5,117,"2,73%"
8,ISCHILIN,QUILINO ESTACION,4200,196,4210,200,-4,10,"0,24%"
10,MARCOS JUAREZ,CAMILO ALDAO,4149,198,4129,201,-3,-20,"-0,48%"
10,MARCOS JUAREZ,ISLA VERDE,4118,199,4111,202,-3,-7,"-0,17%"
3,CAPITAL,PALMAR,3931,203,4073,203,0,142,"3,61%"
3,CAPITAL,VILLA BUSTOS,4055,200,4072,204,-4,17,"0,42%"
1,UNION,BALLESTEROS,3673,205,3868,205,0,195,"5,31%"
15,RIO PRIMERO,LA PARA,3669,206,3769,206,0,100,"2,73%"
7,GRAL SAN MARTIN,ETRURIA,3620,207,3719,207,0,99,"2,73%"
3,CAPITAL,VILLA ALLENDE PARQUE,3600,209,3658,208,1,58,"1,61%"
21,SAN JUSTO,LA FRANCIA,3530,210,3581,209,1,51,"1,44%"
2,CALAMUCHITA,VILLA DEL DIQUE,3325,212,3550,210,2,225,"6,77%"
3,CAPITAL,VILLA RIVERA INDARTE,3697,204,3545,211,-7,-152,"-4,11%"
3,CAPITAL,CONGRESO,3290,214,3496,212,2,206,"6,26%"
1,UNION,MORRISON,3317,213,3492,213,0,175,"5,28%"
10,MARCOS JUAREZ,INRIVILLE,3487,211,3450,214,-3,-37,"-1,06%"
14,RIO CUARTO,SAN BASILIO,3266,215,3392,215,0,126,"3,86%"
4,COLON,ASCOCHINGA,3132,217,3327,216,1,195,"6,23%"
6,GENERAL ROCA,DEL CAMPILLO,3214,216,3192,217,-1,-22,"-0,68%"
7,GRAL SAN MARTIN,TIO PUJIO,3121,218,3192,218,0,71,"2,27%"
2,CALAMUCHITA,SAN AGUSTIN,3066,220,3165,219,1,99,"3,23%"
10,MARCOS JUAREZ,ALEJO LEDESMA,3106,219,3157,220,-1,51,"1,64%"
21,SAN JUSTO,TRANSITO,3044,221,3105,221,0,61,"2,00%"
18,ROQUE SAENZ PEÑA,SERRANO,3034,222,3072,222,0,38,"1,25%"
20,SAN JAVIER,LA PAZ,2852,227,3062,223,4,210,"7,36%"
22,SANTA MARIA,VILLA PARQUE SANTA ANA,2572,237,2999,224,13,427,"16,60%"
22,SANTA MARIA,YOCSINA,2634,233,2991,225,8,357,"13,55%"
21,SAN JUSTO,SACANTA,2940,224,2984,226,-2,44,"1,50%"
7,GRAL SAN MARTIN,ARROYO CABRAL,2890,225,2967,227,-2,77,"2,66%"
2,CALAMUCHITA,LOS CONDORES,2833,229,2945,228,1,112,"3,95%"
21,SAN JUSTO,ALICIA,3015,223,2927,229,-6,-88,"-2,92%"
7,GRAL SAN MARTIN,LA PLAYOSA,2848,228,2905,230,-2,57,"2,00%"
14,RIO CUARTO,ELENA,2865,226,2891,231,-5,26,"0,91%"
13,PUNILLA,VILLA SANTA CRUZ DEL LAGO,2540,241,2881,232,9,341,"13,43%"
1,UNION,SAN MARCOS SUD,2757,230,2823,233,-3,66,"2,39%"
6,GENERAL ROCA,VILLA VALERIA,2687,231,2778,234,-3,91,"3,39%"
3,CAPITAL,COUNTRYS DEL OESTE,2576,236,2772,235,1,196,"7,61%"
3,CAPITAL,JARDIN ARENALES,2553,239,2733,236,3,180,"7,05%"
23,SOBREMONTE,CHAÑAR,2548,240,2733,237,3,185,"7,26%"
14,RIO CUARTO,ACHIRAS,2611,234,2680,238,-4,69,"2,64%"
3,CAPITAL,CIUDAD OBISPO ANGELELLI,2325,253,2679,239,14,354,"15,23%"
5,CRUZ DEL EJE,SERREZUELA,2662,232,2675,240,-8,13,"0,49%"
2,CALAMUCHITA,RUMIPAL,2439,245,2662,241,4,223,"9,14%"
10,MARCOS JUAREZ,ROCA,2587,235,2648,242,-7,61,"2,36%"
14,RIO CUARTO,LAS ACEQUIAS,2569,238,2638,243,-5,69,"2,69%"
3,CAPITAL,NUESTRO HOGAR III,2135,258,2596,244,14,461,"21,59%"
16,RIO SECO,SEBASTIAN ELCANO,2514,242,2589,245,-3,75,"2,98%"
5,CRUZ DEL EJE,SAN MARCOS SIERRAS,2333,251,2555,246,5,222,"9,52%"
3,CAPITAL,CIUDAD DE MIS SUEÑOS,2326,252,2535,247,5,209,"8,99%"
10,MARCOS JUAREZ,LOS SURGENTES,2509,243,2477,248,-5,-32,"-1,28%"
15,RIO PRIMERO,OBISPO TREJO,2407,247,2467,249,-2,60,"2,49%"
19,SAN ALBERTO,NONO,2381,248,2462,250,-2,81,"3,40%"
22,SANTA MARIA,SAN NICOLAS,1744,285,2461,251,34,717,"41,11%"
1,UNION,PASCANAS,2474,244,2458,252,-8,-16,"-0,65%"
17,RIO SEGUNDO,SANTIAGO TEMPLE,2425,246,2448,253,-7,23,"0,95%"
4,COLON,AGUA DE ORO,2220,255,2420,254,1,200,"9,01%"
21,SAN JUSTO,LASPIUR,2376,249,2386,255,-6,10,"0,42%"
1,UNION,ORDOÑEZ,2356,250,2381,256,-6,25,"1,06%"
24,TERCERO ARRIBA,ASCASUBI,2264,254,2309,257,-3,45,"1,99%"
3,CAPITAL,VILLA ESQUIU,2110,262,2307,258,4,197,"9,34%"
20,SAN JAVIER,LOS CERRILLOS,2021,266,2299,259,7,278,"13,76%"
3,CAPITAL,LA FLORESTA SUD,2121,260,2291,260,0,170,"8,02%"
3,CAPITAL,VILLA EUCARISTICA,1942,272,2225,261,11,283,"14,57%"
17,RIO SEGUNDO,CALCHIN,2150,256,2211,262,-6,61,"2,84%"
20,SAN JAVIER,SAN JOSE,2119,261,2206,263,-2,87,"4,11%"
9,JUAREZ CELMAN,SANTA EUFEMIA,2122,259,2158,264,-5,36,"1,70%"
21,SAN JUSTO,MIRAMAR DE ANSENUZA,2081,263,2148,265,-2,67,"3,22%"
10,MARCOS JUAREZ,GUATIMOZIN,2147,257,2108,266,-9,-39,"-1,82%"
13,PUNILLA,VILLA PARQUE SIQUIMAN,1746,284,2105,267,17,359,"20,56%"
11,MINAS,SAN CARLOS,2028,265,2103,268,-3,75,"3,70%"
15,RIO PRIMERO,LA PUERTA,2012,267,2102,269,-2,90,"4,47%"
26,TULUMBA,LAS ARRIAS,2046,264,2035,270,-6,-11,"-0,54%"
7,GRAL SAN MARTIN,TICINO,1998,268,2017,271,-3,19,"0,95%"
25,TOTORAL,SINSACATE,1774,280,1995,272,8,221,"12,46%"
10,MARCOS JUAREZ,BALDISSERA,1992,269,1988,273,-4,-4,"-0,20%"
12,POCHO,SALSACATE,1978,270,1982,274,-4,4,"0,20%"
4,COLON,GENERAL PAZ,1863,275,1973,275,0,110,"5,90%"
21,SAN JUSTO,EL ARAÑADO,1965,271,1956,276,-5,-9,"-0,46%"
3,CAPITAL,VILLA BOEDO,1742,286,1944,277,9,202,"11,60%"
9,JUAREZ CELMAN,CARNERILLO,1884,274,1929,278,-4,45,"2,39%"
21,SAN JUSTO,EL TIO,1850,277,1901,279,-2,51,"2,76%"
26,TULUMBA,TULUMBA,1844,278,1899,280,-2,55,"2,98%"
3,CAPITAL,DEAN FUNES,1892,273,1888,281,-8,-4,"-0,21%"
21,SAN JUSTO,ALTOS DE CHIPION,1853,276,1886,282,-6,33,"1,78%"
3,CAPITAL,AMPLIACION CABILDO,1555,296,1868,283,13,313,"20,13%"
21,SAN JUSTO,CONCEPCION,1767,281,1826,284,-3,59,"3,34%"
14,RIO CUARTO,BAIGORRIA,1757,282,1816,285,-3,59,"3,36%"
13,PUNILLA,YCHO CRUZ,1620,292,1802,286,6,182,"11,23%"
6,GENERAL ROCA,BUCHARDO,1803,279,1777,287,-8,-26,"-1,44%"
21,SAN JUSTO,MARULL,1757,283,1770,288,-5,13,"0,74%"
17,RIO SEGUNDO,CARRILOBO,1705,287,1735,289,-2,30,"1,76%"
22,SANTA MARIA,BARRIO PRIMERO DE MAYO,1348,317,1730,290,27,382,"28,34%"
21,SAN JUSTO,SAN BARTOLOME,1549,298,1728,291,7,179,"11,56%"
22,SANTA MARIA,VILLA EL PRADO,1365,314,1717,292,22,352,"25,79%"
25,TOTORAL,LAS PEÑAS,1673,290,1715,293,-3,42,"2,51%"
15,RIO PRIMERO,PIQUILLIN,1676,288,1699,294,-6,23,"1,37%"
24,TERCERO ARRIBA,CORRALITO,1673,289,1695,295,-6,22,"1,32%"
2,CALAMUCHITA,VILLA YACANTO,1443,305,1673,296,9,230,"15,94%"
20,SAN JAVIER,LAS TAPIAS,1523,301,1648,297,4,125,"8,21%"
6,GENERAL ROCA,MATTALDI,1633,291,1635,298,-7,2,"0,12%"
22,SANTA MARIA,BOUWER,1553,297,1601,299,-2,48,"3,09%"
1,UNION,VIAMONTE,1574,294,1599,300,-6,25,"1,59%"
21,SAN JUSTO,LA TORDILLA,1566,295,1596,301,-6,30,"1,92%"
1,UNION,PUEBLO ITALIANO,1585,293,1594,302,-9,9,"0,57%"
2,CALAMUCHITA,LA CRUZ,1536,300,1579,303,-3,43,"2,80%"
17,RIO SEGUNDO,LAS JUNTURAS,1545,299,1552,304,-5,7,"0,45%"
7,GRAL SAN MARTIN,ARROYO ALGODON,1492,302,1521,305,-3,29,"1,94%"
1,UNION,SAN ANTONIO,1446,304,1516,306,-2,70,"4,84%"
2,CALAMUCHITA,LOS REARTES,1328,318,1513,307,11,185,"13,93%"
9,JUAREZ CELMAN,REDUCCION,1425,306,1497,308,-2,72,"5,05%"
1,UNION,IDIAZABAL,1470,303,1460,309,-6,-10,"-0,68%"
24,TERCERO ARRIBA,DALMACIO VELEZ,1407,308,1455,310,-2,48,"3,41%"
18,ROQUE SAENZ PEÑA,LA CESIRA,1399,310,1433,311,-1,34,"2,43%"
22,SANTA MARIA,FALDA DEL CARMEN,1266,320,1433,312,8,167,"13,19%"
19,SAN ALBERTO,SAN VICENTE,1404,309,1432,313,-4,28,"1,99%"
1,UNION,CINTRA,1350,316,1421,314,2,71,"5,26%"
22,SANTA MARIA,LOZADA,1414,307,1419,315,-8,5,"0,35%"
5,CRUZ DEL EJE,EL BRETE,1172,334,1414,316,18,242,"20,65%"
17,RIO SEGUNDO,COSTA SACATE,1377,311,1386,317,-6,9,"0,65%"
7,GRAL SAN MARTIN,LA LAGUNA,1355,315,1384,318,-3,29,"2,14%"
3,CAPITAL,CHACHAPOYAS,1265,321,1382,319,2,117,"9,25%"
17,RIO SEGUNDO,COLAZO,1373,312,1377,320,-8,4,"0,29%"
2,CALAMUCHITA,VI.CIUD.PQUE.LOS REARTES,1095,344,1368,321,23,273,"24,93%"
22,SANTA MARIA,POTRERO DE GARAY,1241,322,1363,322,0,122,"9,83%"
1,UNION,ESCALANTE,1367,313,1348,323,-10,-19,"-1,39%"
5,CRUZ DEL EJE,TUCLAME,1219,323,1322,324,-1,103,"8,45%"
13,PUNILLA,ESTANCIA VIEJA,1038,352,1300,325,27,262,"25,24%"
20,SAN JAVIER,LUYABA,1208,329,1298,326,3,90,"7,45%"
13,PUNILLA,SAN ROQUE,1103,343,1293,327,16,190,"17,23%"
20,SAN JAVIER,LOS HORNILLOS,1169,335,1283,328,7,114,"9,75%"
24,TERCERO ARRIBA,PAMPAYASTA SUD,1271,319,1274,329,-10,3,"0,24%"
3,CAPITAL,VILLA WARCALDE,1168,336,1266,330,6,98,"8,39%"
3,CAPITAL,LA DOROTEA,1215,324,1263,331,-7,48,"3,95%"
7,GRAL SAN MARTIN,PASCO,1195,330,1248,332,-2,53,"4,44%"
13,PUNILLA,MAYU SUMAJ,1115,341,1244,333,8,129,"11,57%"
20,SAN JAVIER,YACANTO,1177,333,1236,334,-1,59,"5,01%"
14,RIO CUARTO,ALPA CORRAL,1215,325,1233,335,-10,18,"1,48%"
21,SAN JUSTO,LAS VARAS,1177,332,1222,336,-4,45,"3,82%"
22,SANTA MARIA,LOS CEDROS,1136,338,1219,337,1,83,"7,31%"
21,SAN JUSTO,EL FORTIN,1212,327,1206,338,-11,-6,"-0,50%"
4,COLON,EL MANZANO,1129,339,1191,339,0,62,"5,49%"
8,ISCHILIN,QUILINO VILLA,983,357,1189,340,17,206,"20,96%"
25,TOTORAL,CAÑADA DE LUQUE,1185,331,1188,341,-10,3,"0,25%"
21,SAN JUSTO,MARINA,1208,328,1183,342,-14,-25,"-2,07%"
9,JUAREZ CELMAN,HUANCHILLA,1212,326,1176,343,-17,-36,"-2,97%"
18,ROQUE SAENZ PEÑA,MELO,1147,337,1150,344,-7,3,"0,26%"
25,TOTORAL,SARMIENTO,1088,347,1145,345,2,57,"5,24%"
1,UNION,ALTO ALEGRE,1122,340,1144,346,-6,22,"1,96%"
2,CALAMUCHITA,RIO DE LOS SAUCES,1109,342,1142,347,-5,33,"2,98%"
22,SANTA MARIA,VILLA LA BOLSA,974,359,1103,348,11,129,"13,24%"
9,JUAREZ CELMAN,CHARRAS,1041,351,1086,349,2,45,"4,32%"
15,RIO PRIMERO,CAPILLA DE REMEDIOS,1065,349,1075,350,-1,10,"0,94%"
6,GENERAL ROCA,ITALO,1091,345,1068,351,-6,-23,"-2,11%"
10,MARCOS JUAREZ,CAVANAGH,1056,350,1065,352,-2,9,"0,85%"
14,RIO CUARTO,BULNES,1083,348,1056,353,-5,-27,"-2,49%"
26,TULUMBA,LUCIO V MANSILLA,1088,346,1055,354,-8,-33,"-3,03%"
19,SAN ALBERTO,SAN LORENZO,961,361,1053,355,6,92,"9,57%"
22,SANTA MARIA,VALLE DE ANIZACATE,793,376,1040,356,20,247,"31,15%"
5,CRUZ DEL EJE,PASO VIEJO,978,358,1035,357,1,57,"5,83%"
7,GRAL SAN MARTIN,CHAZON,994,355,1024,358,-3,30,"3,02%"
4,COLON,MI GRANJA,915,368,1024,359,9,109,"11,91%"
19,SAN ALBERTO,AMBUL,944,365,1022,360,5,78,"8,26%"
13,PUNILLA,LOS COCOS,1022,353,1018,361,-8,-4,"-0,39%"
21,SAN JUSTO,LA PAQUITA,987,356,1018,362,-6,31,"3,14%"
12,POCHO,CHANCANI,1010,354,1015,363,-9,5,"0,50%"
9,JUAREZ CELMAN,BENGOLEA,971,360,993,364,-4,22,"2,27%"
7,GRAL SAN MARTIN,AUSONIA,946,364,977,365,-1,31,"3,28%"
17,RIO SEGUNDO,MATORRALES,956,363,973,366,-3,17,"1,78%"
22,SANTA MARIA,VILLA LOS AROMOS,850,373,956,367,6,106,"12,47%"
11,MINAS,CIENAGA DEL CORO,926,366,946,368,-2,20,"2,16%"
17,RIO SEGUNDO,MANFREDI,918,367,941,369,-2,23,"2,51%"
15,RIO PRIMERO,VILLA FONTANA,911,369,933,370,-1,22,"2,41%"
5,CRUZ DEL EJE,GUANACO MUERTO,958,362,932,371,-9,-26,"-2,71%"
14,RIO CUARTO,LAS VERTIENTES,908,370,931,372,-2,23,"2,53%"
5,CRUZ DEL EJE,MEDIA NARANJA,862,371,924,373,-2,62,"7,19%"
16,RIO SECO,GUTEMBERG,860,372,898,374,-2,38,"4,42%"
19,SAN ALBERTO,SAUCE ARRIBA,797,375,865,375,0,68,"8,53%"
1,UNION,BALLESTEROS SUD,675,391,854,376,15,179,"26,52%"
22,SANTA MARIA,VILLA CIUDAD DE AMERICA,744,382,850,377,5,106,"14,25%"
20,SAN JAVIER,SAN JAVIER,724,384,841,378,6,117,"16,16%"
2,CALAMUCHITA,LA CUMBRECITA,762,379,834,379,0,72,"9,45%"
16,RIO SECO,CANDELARIA NORTE,764,378,825,380,-2,61,"7,98%"
13,PUNILLA,SAN ESTEBAN,753,381,805,381,0,52,"6,91%"
5,CRUZ DEL EJE,LOS CHAÑARITOS,769,377,802,382,-5,33,"4,29%"
14,RIO CUARTO,CHAJAN,827,374,801,383,-9,-26,"-3,14%"
3,CAPITAL,LA FLORESTA NORTE,702,388,784,384,4,82,"11,68%"
14,RIO CUARTO,LA CAUTIVA,736,383,782,385,-2,46,"6,25%"
19,SAN ALBERTO,LAS RABONAS,717,386,779,386,0,62,"8,65%"
13,PUNILLA,CASA GRANDE,643,401,763,387,14,120,"18,66%"
10,MARCOS JUAREZ,SAIRA,755,380,762,388,-8,7,"0,93%"
9,JUAREZ CELMAN,LOS CISNES,673,392,760,389,3,87,"12,93%"
5,CRUZ DEL EJE,LAS PLAYAS,618,407,754,390,17,136,"22,01%"
16,RIO SECO,RAYO CORTADO,700,389,743,391,-2,43,"6,14%"
25,TOTORAL,LA PAMPA,718,385,729,392,-7,11,"1,53%"
5,CRUZ DEL EJE,BAÑADO DE SOTO,711,387,722,393,-6,11,"1,55%"
14,RIO CUARTO,MONTE DE LOS GAUCHOS,686,390,717,394,-4,31,"4,52%"
19,SAN ALBERTO,ARROYO DE LOS PATOS,610,409,713,395,14,103,"16,89%"
21,SAN JUSTO,SEEBER,659,394,706,396,-2,47,"7,13%"
13,PUNILLA,CHARBONIER,658,395,704,397,-2,46,"6,99%"
21,SAN JUSTO,VIGNAUD,645,399,685,398,1,40,"6,20%"
10,MARCOS JUAREZ,LA ITALIANA,639,402,674,399,3,35,"5,48%"
17,RIO SEGUNDO,CALCHIN OESTE,668,393,668,400,-7,0,"0,00%"
21,SAN JUSTO,QUEBRACHO HERRADO,653,396,658,401,-5,5,"0,77%"
9,JUAREZ CELMAN,OLAETA,644,400,656,402,-2,12,"1,86%"
26,TULUMBA,SAN JOSE DE LAS SALINAS,648,398,654,403,-5,6,"0,93%"
25,TOTORAL,SITON,626,405,653,404,1,27,"4,31%"
1,UNION,CHILIBROSTE,615,408,653,405,3,38,"6,18%"
22,SANTA MARIA,SAN ISIDRO,623,406,650,406,0,27,"4,33%"
22,SANTA MARIA,RAFAEL GARCIA,648,397,648,407,-10,0,"0,00%"
7,GRAL SAN MARTIN,SILVIO PELLICO,630,404,633,408,-4,3,"0,48%"
1,UNION,GOULD,632,403,628,409,-6,-4,"-0,63%"
24,TERCERO ARRIBA,LOS ZORROS,603,410,621,410,0,18,"2,99%"
8,ISCHILIN,CHUÑA,593,411,601,411,0,8,"1,35%"
26,TULUMBA,SAN PEDRO NORTE,587,413,600,412,1,13,"2,21%"
7,GRAL SAN MARTIN,LUCA,588,412,587,413,-1,-1,"-0,17%"
13,PUNILLA,CABALANGO,440,441,585,414,27,145,"32,95%"
18,ROQUE SAENZ PEÑA,VILLA ROSSI,568,416,581,415,1,13,"2,29%"
8,ISCHILIN,OLIVARES SAN NICOLAS,571,415,579,416,-1,8,"1,40%"
22,SANTA MARIA,JOSE DE LA QUINTANA,514,425,578,417,8,64,"12,45%"
7,GRAL SAN MARTIN,PALESTINA,539,422,568,418,4,29,"5,38%"
2,CALAMUCHITA,VILLA AMANCAY,505,427,567,419,8,62,"12,28%"
14,RIO CUARTO,WASHINGTON,556,419,563,420,-1,7,"1,26%"
24,TERCERO ARRIBA,CNIA ALMADA,565,417,562,421,-4,-3,"-0,53%"
14,RIO CUARTO,TOSQUITA,526,423,552,422,1,26,"4,94%"
21,SAN JUSTO,PROSPERIDAD,553,420,548,423,-3,-5,"-0,90%"
23,SOBREMONTE,POZO NUEVO,561,418,547,424,-6,-14,"-2,50%"
18,ROQUE SAENZ PEÑA,ROSALES,540,421,545,425,-4,5,"0,93%"
19,SAN ALBERTO,LAS CALLES,506,426,535,426,0,29,"5,73%"
1,UNION,MONTE LEÑA,514,424,530,427,-3,16,"3,11%"
5,CRUZ DEL EJE,LA HIGUERA,579,414,509,428,-14,-70,"-12,09%"
15,RIO PRIMERO,DIEGO DE ROJAS,503,428,508,429,-1,5,"0,99%"
20,SAN JAVIER,LA POBLACION,459,436,503,430,6,44,"9,59%"
8,ISCHILIN,AVELLANEDA,485,432,501,431,1,16,"3,30%"
12,POCHO,POCHO,499,429,488,432,-3,-11,"-2,20%"
22,SANTA MARIA,MONTE RALO,488,431,481,433,-2,-7,"-1,43%"
13,PUNILLA,CUESTA BLANCA,425,447,477,434,13,52,"12,24%"
14,RIO CUARTO,SUCO,477,433,473,435,-2,-4,"-0,84%"
22,SANTA MARIA,LA SERRANITA,427,445,471,436,9,44,"10,30%"
17,RIO SEGUNDO,RINCON,446,439,469,437,2,23,"5,16%"
16,RIO SECO,RINCONADA,466,434,463,438,-4,-3,"-0,64%"
14,RIO CUARTO,LAS ALBAHACAS,440,440,463,439,1,23,"5,23%"
3,CAPITAL,VILLA GRAN PARQUE,420,448,461,440,8,41,"9,76%"
26,TULUMBA,ROSARIO DEL SALADILLO,493,430,451,441,-11,-42,"-8,52%"
16,RIO SECO,LOS HOYOS,453,438,447,442,-4,-6,"-1,32%"
23,SOBREMONTE,CAMINIAGA,453,437,442,443,-6,-11,"-2,43%"
3,CAPITAL,CAMINO A COLONIA TIROLESA,460,435,431,444,-9,-29,"-6,30%"
14,RIO CUARTO,CHUCUL,413,450,431,445,5,18,"4,36%"
20,SAN JAVIER,CONLARA,401,451,430,446,5,29,"7,23%"
24,TERCERO ARRIBA,PAMPAYASTA NORTE,425,446,424,447,-1,-1,"-0,24%"
1,UNION,BISMARCK,415,449,420,448,1,5,"1,20%"
11,MINAS,ESTANCIA DE GUADALUPE,429,444,413,449,-5,-16,"-3,73%"
16,RIO SECO,PUESTO DE CASTRO,439,442,405,450,-8,-34,"-7,74%"
19,SAN ALBERTO,PANAHOLMA,396,454,399,451,3,3,"0,76%"
20,SAN JAVIER,QUEBRACHO LADEADO,254,490,398,452,38,144,"56,69%"
17,RIO SEGUNDO,CAPILLA DEL CARMEN,364,456,391,453,3,27,"7,42%"
25,TOTORAL,CANDELARIA,400,452,390,454,-2,-10,"-2,50%"
5,CRUZ DEL EJE,ALTO DE LOS QUEBRACHOS,430,443,388,455,-12,-42,"-9,77%"
4,COLON,VILLA CERRO AZUL,363,457,382,456,1,19,"5,23%"
8,ISCHILIN,CAÑADA DE RIO PINTO,398,453,376,457,-4,-22,"-5,53%"
21,SAN JUSTO,EL FUERTECITO,373,455,375,458,-3,2,"0,54%"
21,SAN JUSTO,LUXARDO,358,458,364,459,-1,6,"1,68%"
15,RIO PRIMERO,PEDRO E.VIVAS,352,460,363,460,0,11,"3,13%"
8,ISCHILIN,COPACABANA,347,462,357,461,1,10,"2,88%"
16,RIO SECO,CERRO COLORADO,339,467,351,462,5,12,"3,54%"
16,RIO SECO,SANTA ELENA,346,463,350,463,0,4,"1,16%"
4,COLON,LA PUERTA,347,461,349,464,-3,2,"0,58%"
15,RIO PRIMERO,LA POSTA,337,468,345,465,3,8,"2,37%"
24,TERCERO ARRIBA,GENERAL FOTHERINGHAM,352,459,340,466,-7,-12,"-3,41%"
23,SOBREMONTE,CHUÑAHUASI,344,464,337,467,-3,-7,"-2,03%"
25,TOTORAL,SIMBOLAR,319,470,330,468,2,11,"3,45%"
15,RIO PRIMERO,ESQUINA,341,465,327,469,-4,-14,"-4,11%"
22,SANTA MARIA,BAJO CHICO,298,475,324,470,5,26,"8,72%"
14,RIO CUARTO,MALENA,308,473,318,471,2,10,"3,25%"
10,MARCOS JUAREZ,CAP.B.O HIGGINS,320,469,317,472,-3,-3,"-0,94%"
15,RIO PRIMERO,COMECHINGONES,311,471,310,473,-2,-1,"-0,32%"
2,CALAMUCHITA,LOS MOLINOS,301,474,309,474,0,8,"2,66%"
8,ISCHILIN,VILLA GUTIERREZ,279,479,305,475,4,26,"9,32%"
12,POCHO,TALA CAÑADA,283,478,302,476,2,19,"6,71%"
11,MINAS,GUASAPAMPA,290,477,300,477,0,10,"3,45%"
6,GENERAL ROCA,VILLA SARMIENTO,308,472,297,478,-6,-11,"-3,57%"
3,CAPITAL,BAJADA DE PIEDRA,340,466,294,479,-13,-46,"-13,53%"
17,RIO SEGUNDO,LOS CHAÑARITOS,278,480,292,480,0,14,"5,04%"
21,SAN JUSTO,TORO PUJIO,252,492,291,481,11,39,"15,48%"
4,COLON,TINOCO,263,484,283,482,2,20,"7,60%"
10,MARCOS JUAREZ,BARGE,228,504,283,483,21,55,"24,12%"
2,CALAMUCHITA,LAS BAJADAS,269,482,278,484,-2,9,"3,35%"
12,POCHO,SAN JERONIMO,290,476,274,485,-9,-16,"-5,52%"
4,COLON,COLONIA VICENTE AGÜERO,277,481,269,486,-5,-8,"-2,89%"
15,RIO PRIMERO,EL CRISPIN,253,491,268,487,4,15,"5,93%"
6,GENERAL ROCA,BRUZONE,240,498,262,488,10,22,"9,17%"
24,TERCERO ARRIBA,LAS ISLETILLAS,262,485,260,489,-4,-2,"-0,76%"
15,RIO PRIMERO,LAS SALADAS,257,486,258,490,-4,1,"0,39%"
12,POCHO,LAS PALMAS,254,489,257,491,-2,3,"1,18%"
6,GENERAL ROCA,PINCEN,254,488,255,492,-4,1,"0,39%"
2,CALAMUCHITA,AMBOY,240,497,253,493,4,13,"5,42%"
19,SAN ALBERTO,LOS ESPINILLOS,223,507,253,494,13,30,"13,45%"
14,RIO CUARTO,LA CAROLINA,243,496,251,495,1,8,"3,29%"
25,TOTORAL,SANTA CATALINA,234,501,251,496,5,17,"7,26%"
26,TULUMBA,EL RODEO,243,495,243,497,-2,0,"0,00%"
1,UNION,BREMEN,246,493,239,498,-5,-7,"-2,85%"
15,RIO PRIMERO,CHALACEA,230,502,239,499,3,9,"3,91%"
21,SAN JUSTO,SAN PEDRO,264,483,238,500,-17,-26,"-9,85%"
11,MINAS,LA PLAYA,237,499,238,501,-2,1,"0,42%"
13,PUNILLA,TALA HUASI,235,500,232,502,-2,-3,"-1,28%"
15,RIO PRIMERO,LA QUINTA,255,487,229,503,-16,-26,"-10,20%"
24,TERCERO ARRIBA,PUNTA DEL AGUA,227,506,226,504,2,-1,"-0,44%"
1,UNION,SANTA MARIA,204,512,226,505,7,22,"10,78%"
15,RIO PRIMERO,CAÑADA DE MACHADO,229,503,219,506,-3,-10,"-4,37%"
5,CRUZ DEL EJE,CRUZ DE CAÑA,227,505,218,507,-2,-9,"-3,96%"
3,CAPITAL,CHACRA DE LA MERCED,244,494,216,508,-14,-28,"-11,48%"
2,CALAMUCHITA,CALERAS DE CALAMUCHITA,202,513,210,509,4,8,"3,96%"
5,CRUZ DEL EJE,LA BATEA,169,524,207,510,14,38,"22,49%"
14,RIO CUARTO,LAS PEÑAS,215,509,206,511,-2,-9,"-4,19%"
16,RIO SECO,EUFRASIO LOZA,205,511,205,512,-1,0,"0,00%"
16,RIO SECO,CHAÑAR VIEJO,207,510,204,513,-3,-3,"-1,45%"
1,UNION,ANA ZUMARAN,175,522,202,514,8,27,"15,43%"
22,SANTA MARIA,SAN CLEMENTE,185,518,201,515,3,16,"8,65%"
17,RIO SEGUNDO,PUEBLO LUDUEÑA,189,516,197,516,0,8,"4,23%"
21,SAN JUSTO,VILLA SAN ESTEBAN,189,515,194,517,-2,5,"2,65%"
11,MINAS,LA ARGENTINA,216,508,192,518,-10,-24,"-11,11%"
21,SAN JUSTO,BEIRO,155,535,192,519,16,37,"23,87%"
11,MINAS,TOSNO,186,517,189,520,-3,3,"1,61%"
21,SAN JUSTO,COLONIA PICHANAS,170,523,182,521,2,12,"7,06%"
21,SAN JUSTO,DIEZ DE JULIO,151,539,182,522,17,31,"20,53%"
5,CRUZ DEL EJE,LAS CAÑADAS,193,514,179,523,-9,-14,"-7,25%"
15,RIO PRIMERO,SAGRADA FAMILIA,181,521,175,524,-3,-6,"-3,31%"
14,RIO CUARTO,LOS CUATRO VIENTOS,168,525,175,525,0,7,"4,17%"
22,SANTA MARIA,LA PAISANITA,165,527,173,526,1,8,"4,85%"
21,SAN JUSTO,COLONIA VALTELINA,182,520,171,527,-7,-11,"-6,04%"
2,CALAMUCHITA,VILLA QUILLINZO,160,529,169,528,1,9,"5,63%"
22,SANTA MARIA,LA RANCHERITA,159,531,167,529,2,8,"5,03%"
2,CALAMUCHITA,SEGUNDA USINA,131,549,167,530,19,36,"27,48%"
15,RIO PRIMERO,ATAHONA,166,526,165,531,-5,-1,"-0,60%"
2,CALAMUCHITA,ATHOS PAMPA,151,538,165,532,6,14,"9,27%"
15,RIO PRIMERO,MAQUINISTA GALLINI,182,519,164,533,-14,-18,"-9,89%"
14,RIO CUARTO,ESPINILLO,153,536,163,534,2,10,"6,54%"
11,MINAS,EL CHACHO,158,533,161,535,-2,3,"1,90%"
2,CALAMUCHITA,LUTTI,157,534,157,536,-2,0,"0,00%"
2,CALAMUCHITA,SAN IGNACIO,130,550,153,537,13,23,"17,69%"
26,TULUMBA,CHURQUI CAÑADA,163,528,151,538,-10,-12,"-7,36%"
19,SAN ALBERTO,SAN RAFAEL,158,532,150,539,-7,-8,"-5,06%"
25,TOTORAL,LOS MISTOLES,144,544,149,540,4,5,"3,47%"
5,CRUZ DEL EJE,PICHANAS,159,530,147,541,-11,-12,"-7,55%"
18,ROQUE SAENZ PEÑA,SAN JOAQUIN,146,542,146,542,0,0,"0,00%"
26,TULUMBA,LA TOMA,115,559,146,543,16,31,"26,96%"
11,MINAS,TALAINI,152,537,145,544,-7,-7,"-4,61%"
21,SAN JUSTO,DOS HERMANOS,125,554,144,545,9,19,"15,20%"
15,RIO PRIMERO,LAS GRAMILLAS,137,547,142,546,1,5,"3,65%"
19,SAN ALBERTO,PAMPA DE ACHALA,122,555,142,547,8,20,"16,39%"
10,MARCOS JUAREZ,SALADILLO,136,548,141,548,0,5,"3,68%"
12,POCHO,LOS TALARES,141,545,140,549,-4,-1,"-0,71%"
18,ROQUE SAENZ PEÑA,LEGUIZAMON,120,556,139,550,6,19,"15,83%"
14,RIO CUARTO,VILLA EL CHACAY,126,552,137,551,1,11,"8,73%"
21,SAN JUSTO,MAUNIER,113,561,134,552,9,21,"18,58%"
2,CALAMUCHITA,CALMAYO,126,553,132,553,0,6,"4,76%"
15,RIO PRIMERO,MONTE DEL ROSARIO,146,541,131,554,-13,-15,"-10,27%"
8,ISCHILIN,LOS POZOS,118,557,131,555,2,13,"11,02%"
3,CAPITAL,EL GATEADO,146,543,128,556,-13,-18,"-12,33%"
15,RIO PRIMERO,PLAZA DE MERCEDES,140,546,126,557,-11,-14,"-10,00%"
14,RIO CUARTO,SAN AMBROSIO,128,551,125,558,-7,-3,"-2,34%"
15,RIO PRIMERO,COLONIA LAS CUATRO ESQUINAS,114,560,122,559,1,8,"7,02%"
9,JUAREZ CELMAN,PASO DEL DURAZNO,110,563,122,560,3,12,"10,91%"
3,CAPITAL,AEROPUERTO,150,540,112,561,-21,-38,"-25,33%"
21,SAN JUSTO,ITURRASPE,112,562,112,562,0,0,"0,00%"
14,RIO CUARTO,PUEYRREDON,103,566,111,563,3,8,"7,77%"
15,RIO PRIMERO,EL ALCALDE,116,558,110,564,-6,-6,"-5,17%"
11,MINAS,RUMIHUASI,101,567,103,565,2,2,"1,98%"
18,ROQUE SAENZ PEÑA,RIO BAMBA,99,568,101,566,2,2,"2,02%"
2,CALAMUCHITA,VILLA LA MERCED,34,612,101,567,45,67,"197,06%"
2,CALAMUCHITA,VILLA BERNA,106,565,99,568,-3,-7,"-6,60%"
9,JUAREZ CELMAN,ASSUNTA,74,584,94,569,15,20,"27,03%"
15,RIO PRIMERO,BLAS DE ROSALES,106,564,92,570,-6,-14,"-13,21%"
26,TULUMBA,SANTA CRUZ,97,569,92,571,-2,-5,"-5,15%"
5,CRUZ DEL EJE,IGLESIA VIEJA,71,587,92,572,15,21,"29,58%"
12,POCHO,LAS JARILLAS,93,572,91,573,-1,-2,"-2,15%"
11,MINAS,OJO DE AGUA DE TOTOX,89,575,91,574,1,2,"2,25%"
5,CRUZ DEL EJE,LOS SAUCES,82,579,91,575,4,9,"10,98%"
8,ISCHILIN,TOYOS,82,578,88,576,2,6,"7,32%"
15,RIO PRIMERO,QUEBRACHO,93,571,85,577,-6,-8,"-8,60%"
16,RIO SECO,LA CAÑADA,89,574,85,578,-4,-4,"-4,49%"
11,MINAS,AGUA DE RAMON,89,573,84,579,-6,-5,"-5,62%"
9,JUAREZ CELMAN,PACHECO DE MELO,72,586,84,580,6,12,"16,67%"
14,RIO CUARTO,LA GILDA,73,585,80,581,4,7,"9,59%"
5,CRUZ DEL EJE,CANTERAS QUILPO,95,570,78,582,-12,-17,"-17,89%"
19,SAN ALBERTO,LA CORTADERA,82,577,78,583,-6,-4,"-4,88%"
21,SAN JUSTO,COLONIA ANITA,79,581,78,584,-3,-1,"-1,27%"
5,CRUZ DEL EJE,SANTA ANA,86,576,75,585,-9,-11,"-12,79%"
14,RIO CUARTO,LA INVERNADA,71,588,74,586,2,3,"4,23%"
9,JUAREZ CELMAN,EL RASTREADOR,60,595,74,587,8,14,"23,33%"
2,CALAMUCHITA,VILLA CAÑADA DEL SAUCE,80,580,72,588,-8,-8,"-10,00%"
14,RIO CUARTO,LAS CAÑITAS,49,601,71,589,12,22,"44,90%"
12,POCHO,EL MEDANITO,64,591,68,590,1,4,"6,25%"
8,ISCHILIN,ISCHILIN,76,582,65,591,-9,-11,"-14,47%"
25,TOTORAL,MACHA,76,583,65,592,-9,-11,"-14,47%"
6,GENERAL ROCA,ONAGOITY,67,590,64,593,-3,-3,"-4,48%"
7,GRAL SAN MARTIN,MOJARRAS,68,589,61,594,-5,-7,"-10,29%"
11,MINAS,PIEDRITA BLANCA,61,594,60,595,-1,-1,"-1,64%"
4,COLON,SANTA TERESA,63,592,59,596,-4,-4,"-6,35%"
8,ISCHILIN,JAIME PETER,55,597,59,597,0,4,"7,27%"
5,CRUZ DEL EJE,LOS LEONES,56,596,58,598,-2,2,"3,57%"
15,RIO PRIMERO,LAS HERAS,61,593,57,599,-6,-4,"-6,56%"
26,TULUMBA,ISLA DE SAN ANTONIO,49,602,49,600,2,0,"0,00%"
22,SANTA MARIA,COSME,50,600,48,601,-1,-2,"-4,00%"
19,SAN ALBERTO,VILLA BENEGAS,48,603,48,602,1,0,"0,00%"
17,RIO SEGUNDO,COLONIA VIDELA,45,605,47,603,2,2,"4,44%"
6,GENERAL ROCA,RANQUELES,51,599,45,604,-5,-6,"-11,76%"
5,CRUZ DEL EJE,EL ABRA,45,604,43,605,-1,-2,"-4,44%"
16,RIO SECO,ENCRUCIJADA,42,607,43,606,1,1,"2,38%"
5,CRUZ DEL EJE,CANDELARIA,51,598,40,607,-9,-11,"-21,57%"
15,RIO PRIMERO,PUNTA DEL AGUA,38,610,37,608,2,-1,"-2,63%"
19,SAN ALBERTO,EL VOLCAN,35,611,37,609,2,2,"5,71%"
1,UNION,VILLA LOS PATOS,43,606,34,610,-4,-9,"-20,93%"
7,GRAL SAN MARTIN,SANABRIA,40,608,34,611,-3,-6,"-15,00%"
26,TULUMBA,EL BAÑADO,39,609,34,612,-3,-5,"-12,82%"
20,SAN JAVIER,EL MANANTIAL,29,614,34,613,1,5,"17,24%"
10,MARCOS JUAREZ,VILLA ELISA,26,618,32,614,4,6,"23,08%"
26,TULUMBA,LA CAÑADA,28,615,27,615,0,-1,"-3,57%"
5,CRUZ DEL EJE,SAN ANTONIO,31,613,26,616,-3,-5,"-16,13%"
19,SAN ALBERTO,LOS CERROS,20,622,24,617,5,4,"20,00%"
11,MINAS,RUMIACO,27,617,23,618,-1,-4,"-14,81%"
8,ISCHILIN,CANTERAS,23,619,23,619,0,0,"0,00%"
1,UNION,CARCANO,17,625,23,620,5,6,"35,29%"
22,SANTA MARIA,BUENA VISTA,27,616,19,621,-5,-8,"-29,63%"
19,SAN ALBERTO,ALTAUTINA,21,621,19,622,-1,-2,"-9,52%"
6,GENERAL ROCA,LECUEDER,18,623,19,623,0,1,"5,56%"
21,SAN JUSTO,SAUZE,22,620,17,624,-4,-5,"-22,73%"
26,TULUMBA,LAS MASITAS,16,627,14,625,2,-2,"-12,50%"
2,CALAMUCHITA,CHAMPAQUI,12,629,10,626,3,-2,"-16,67%"
14,RIO CUARTO,LA ARGENTINA,17,626,9,627,-1,-8,"-47,06%"
17,RIO SEGUNDO,CAÑADA DE MACHADO SUD,17,624,8,628,-4,-9,"-52,94%"
3,CAPITAL,CNO. A PAJAS BLANCAS,11,630,8,629,1,-3,"-27,27%"
1,UNION,CORRAL DEL BAJO,13,628,7,630,-2,-6,"-46,15%"