Seccion,Circuito,Electores 2015,Electores 2017,Dif,Crec
CALAMUCHITA,AMBOY,240,253,13,"5,42%"
CALAMUCHITA,ATHOS PAMPA,151,165,14,"9,27%"
CALAMUCHITA,CALERAS DE CALAMUCHITA,202,210,8,"3,96%"
CALAMUCHITA,CALMAYO,126,132,6,"4,76%"
CALAMUCHITA,CHAMPAQUI,12,10,-2,"-16,67%"
CALAMUCHITA,EMBALSE,7104,7463,359,"5,05%"
CALAMUCHITA,LA CRUZ,1536,1579,43,"2,80%"
CALAMUCHITA,LA CUMBRECITA,762,834,72,"9,45%"
CALAMUCHITA,LAS BAJADAS,269,278,9,"3,35%"
CALAMUCHITA,LOS CONDORES,2833,2945,112,"3,95%"
CALAMUCHITA,LOS MOLINOS,301,309,8,"2,66%"
CALAMUCHITA,LOS REARTES,1328,1513,185,"13,93%"
CALAMUCHITA,LUTTI,157,157,0,"0,00%"
CALAMUCHITA,RIO DE LOS SAUCES,1109,1142,33,"2,98%"
CALAMUCHITA,RUMIPAL,2439,2662,223,"9,14%"
CALAMUCHITA,SAN AGUSTIN,3066,3165,99,"3,23%"
CALAMUCHITA,SAN IGNACIO,130,153,23,"17,69%"
CALAMUCHITA,SANTA ROSA,11640,12509,869,"7,47%"
CALAMUCHITA,SEGUNDA USINA,131,167,36,"27,48%"
CALAMUCHITA,VI.CIUD.PQUE.LOS REARTES,1095,1368,273,"24,93%"
CALAMUCHITA,VILLA AMANCAY,505,567,62,"12,28%"
CALAMUCHITA,VILLA BERNA,106,99,-7,"-6,60%"
CALAMUCHITA,VILLA CAÑADA DEL SAUCE,80,72,-8,"-10,00%"
CALAMUCHITA,VILLA DEL DIQUE,3325,3550,225,"6,77%"
CALAMUCHITA,VILLA GENERAL BELGRANO,7501,8272,771,"10,28%"
CALAMUCHITA,VILLA LA MERCED,34,101,67,"197,06%"
CALAMUCHITA,VILLA QUILLINZO,160,169,9,"5,63%"
CALAMUCHITA,VILLA YACANTO,1443,1673,230,"15,94%"
CAPITAL,AERONAUTICO,4503,4728,225,"5,00%"
CAPITAL,AEROPUERTO,150,112,-38,"-25,33%"
CAPITAL,ALTA CORDOBA,22648,22752,104,"0,46%"
CAPITAL,ALTAMIRA,13676,13933,257,"1,88%"
CAPITAL,ALTO ALBERDI,23149,23555,406,"1,75%"
CAPITAL,ALTO GRAL PAZ,5305,5240,-65,"-1,23%"
CAPITAL,AMPLIACION CABILDO,1555,1868,313,"20,13%"
CAPITAL,ARGUELLO,6656,7191,535,"8,04%"
CAPITAL,ARGUELLO NORTE,17290,18293,1003,"5,80%"
CAPITAL,ARGUELLO PRIMERO,7316,7171,-145,"-1,98%"
CAPITAL,ARGUELLO SEGUNDO,4650,5006,356,"7,66%"
CAPITAL,AVELLANEDA,8703,9171,468,"5,38%"
CAPITAL,AYACUCHO,16822,17047,225,"1,34%"
CAPITAL,BAJADA DE PIEDRA,340,294,-46,"-13,53%"
CAPITAL,BELLA VISTA,17380,18191,811,"4,67%"
CAPITAL,CABILDO,4776,5049,273,"5,72%"
CAPITAL,CAMINO A COLONIA TIROLESA,460,431,-29,"-6,30%"
CAPITAL,CARCANO,5497,5820,323,"5,88%"
CAPITAL,CERRO DE LAS ROSAS,6883,6594,-289,"-4,20%"
CAPITAL,CERRO NORTE,6463,6648,185,"2,86%"
CAPITAL,CHACHAPOYAS,1265,1382,117,"9,25%"
CAPITAL,CHACRA DE LA MERCED,244,216,-28,"-11,48%"
CAPITAL,CIUDAD DE MIS SUEÑOS,2326,2535,209,"8,99%"
CAPITAL,CIUDAD OBISPO ANGELELLI,2325,2679,354,"15,23%"
CAPITAL,CIUDADELA,12227,12183,-44,"-0,36%"
CAPITAL,CNO. A PAJAS BLANCAS,11,8,-3,"-27,27%"
CAPITAL,COFICO,9141,9791,650,"7,11%"
CAPITAL,COLINAS DEL SUR,4756,5111,355,"7,46%"
CAPITAL,COLON,22939,22935,-4,"-0,02%"
CAPITAL,COLONIA LOLA,5178,5322,144,"2,78%"
CAPITAL,COMERCIAL,6881,7055,174,"2,53%"
CAPITAL,CONGRESO,3290,3496,206,"6,26%"
CAPITAL,CORONEL OLMEDO,4524,4632,108,"2,39%"
CAPITAL,COUNTRYS DEL OESTE,2576,2772,196,"7,61%"
CAPITAL,DEAN FUNES,1892,1888,-4,"-0,21%"
CAPITAL,DON BOSCO,6708,6739,31,"0,46%"
CAPITAL,EL GATEADO,146,128,-18,"-12,33%"
CAPITAL,EMPALME,17670,18384,714,"4,04%"
CAPITAL,ESCOBAR,5873,5916,43,"0,73%"
CAPITAL,ESTACION FLORES,12118,12899,781,"6,44%"
CAPITAL,FERREYRA,4774,5033,259,"5,43%"
CAPITAL,GENERAL BUSTOS,13838,13927,89,"0,64%"
CAPITAL,GRAL PAZ,11792,12107,315,"2,67%"
CAPITAL,GRANJA DE FUNES,6703,6771,68,"1,01%"
CAPITAL,GUIÑAZU,6638,6787,149,"2,24%"
CAPITAL,INAUDI,4300,4652,352,"8,19%"
CAPITAL,ITUZAINGO,10548,11101,553,"5,24%"
CAPITAL,JARDIN ARENALES,2553,2733,180,"7,05%"
CAPITAL,JORGE NEWBERY,8247,8251,4,"0,05%"
CAPITAL,JOSE HERNANDEZ,19645,20222,577,"2,94%"
CAPITAL,JOSE IGNACIO DIAZ,25343,26913,1570,"6,20%"
CAPITAL,JUNIORS,7043,7449,406,"5,76%"
CAPITAL,LA DOROTEA,1215,1263,48,"3,95%"
CAPITAL,LA FLORESTA NORTE,702,784,82,"11,68%"
CAPITAL,LA FLORESTA SUD,2121,2291,170,"8,02%"
CAPITAL,LA FRANCE,4942,4987,45,"0,91%"
CAPITAL,LAS MARGARITAS,7968,8009,41,"0,51%"
CAPITAL,LAS PALMAS,14810,14249,-561,"-3,79%"
CAPITAL,LEANDRO N. ALEM,9241,9268,27,"0,29%"
CAPITAL,LOS BOULEVARES,9028,9437,409,"4,53%"
CAPITAL,LOS CERVECEROS,10415,11415,1000,"9,60%"
CAPITAL,LOS NARANJOS,12732,13002,270,"2,12%"
CAPITAL,LOS PARAISOS,13942,14098,156,"1,12%"
CAPITAL,LOS PLATANOS,15734,16250,516,"3,28%"
CAPITAL,LOS ROBLES,7350,8340,990,"13,47%"
CAPITAL,MALDONADO,10703,11243,540,"5,05%"
CAPITAL,MARQUES DE SOBREMONTE,16154,16631,477,"2,95%"
CAPITAL,MATIENZO,12454,12833,379,"3,04%"
CAPITAL,MERCANTIL,3606,4663,1057,"29,31%"
CAPITAL,NUESTRO HOGAR III,2135,2596,461,"21,59%"
CAPITAL,NUEVA CORDOBA,20287,21029,742,"3,66%"
CAPITAL,NUEVA ITALIA,7815,7940,125,"1,60%"
CAPITAL,OBSERVATORIO,21058,21121,63,"0,30%"
CAPITAL,PALMAR,3931,4073,142,"3,61%"
CAPITAL,PANAMERICANO,12300,12869,569,"4,63%"
CAPITAL,PARQUE CAPITAL,12249,12502,253,"2,07%"
CAPITAL,PARQUE HORIZONTE,9858,10449,591,"6,00%"
CAPITAL,PARQUE LICEO,17986,18982,996,"5,54%"
CAPITAL,PARQUE REPUBLICA,12985,13858,873,"6,72%"
CAPITAL,PATRICIOS,17310,17543,233,"1,35%"
CAPITAL,POETA LUGONES,9100,9246,146,"1,60%"
CAPITAL,PROVIDENCIA,4903,5033,130,"2,65%"
CAPITAL,PUEBLO LAS FLORES,17256,17963,707,"4,10%"
CAPITAL,PUEYRREDON,19575,19927,352,"1,80%"
CAPITAL,QUEBRADA LAS ROSAS,6639,6802,163,"2,46%"
CAPITAL,RENACIMIENTO,4482,4715,233,"5,20%"
CAPITAL,RESIDENCIAL SAN ROQUE,14962,16007,1045,"6,98%"
CAPITAL,SAN JORGE,6024,6206,182,"3,02%"
CAPITAL,SAN MARTIN,15226,15282,56,"0,37%"
CAPITAL,SAN VICENTE,15859,15742,-117,"-0,74%"
CAPITAL,SANTA ANA,17339,17627,288,"1,66%"
CAPITAL,SANTA CECILIA,5146,5406,260,"5,05%"
CAPITAL,SANTA ISABEL,12409,12620,211,"1,70%"
CAPITAL,SECCIONAL PRIMERA,15788,16095,307,"1,94%"
CAPITAL,SECCIONAL SEGUNDA,5693,6145,452,"7,94%"
CAPITAL,SECCIONAL TERCERA,19980,20676,696,"3,48%"
CAPITAL,URCA,8063,8049,-14,"-0,17%"
CAPITAL,VALLE ESCONDIDO,3960,4742,782,"19,75%"
CAPITAL,VICOR,4888,5551,663,"13,56%"
CAPITAL,VILLA 9 DE JULIO,7248,7703,455,"6,28%"
CAPITAL,VILLA ALLENDE PARQUE,3600,3658,58,"1,61%"
CAPITAL,VILLA AZALAIS,31065,31918,853,"2,75%"
CAPITAL,VILLA BELGRANO,5310,5134,-176,"-3,31%"
CAPITAL,VILLA BOEDO,1742,1944,202,"11,60%"
CAPITAL,VILLA BUSTOS,4055,4072,17,"0,42%"
CAPITAL,VILLA CABRERA,5899,5859,-40,"-0,68%"
CAPITAL,VILLA CENTENARIO,9704,9704,0,"0,00%"
CAPITAL,VILLA CORNU,5269,4679,-590,"-11,20%"
CAPITAL,VILLA EL LIBERTADOR,25906,26710,804,"3,10%"
CAPITAL,VILLA ESQUIU,2110,2307,197,"9,34%"
CAPITAL,VILLA EUCARISTICA,1942,2225,283,"14,57%"
CAPITAL,VILLA GRAL URQUIZA,11004,11327,323,"2,94%"
CAPITAL,VILLA GRAN PARQUE,420,461,41,"9,76%"
CAPITAL,VILLA LOS PINOS,8417,8468,51,"0,61%"
CAPITAL,VILLA REVOL,15600,15815,215,"1,38%"
CAPITAL,VILLA RIVERA INDARTE,3697,3545,-152,"-4,11%"
CAPITAL,VILLA WARCALDE,1168,1266,98,"8,39%"
CAPITAL,YAPEYU,7902,8173,271,"3,43%"
CAPITAL,YOFRE,7489,7591,102,"1,36%"
COLON,AGUA DE ORO,2220,2420,200,"9,01%"
COLON,ASCOCHINGA,3132,3327,195,"6,23%"
COLON,CALERA,17439,18809,1370,"7,86%"
COLON,CALERA CENTRAL,12301,13522,1221,"9,93%"
COLON,COLONIA CAROYA,16651,17415,764,"4,59%"
COLON,COLONIA TIROLESA,5315,6265,950,"17,87%"
COLON,COLONIA VICENTE AGÜERO,277,269,-8,"-2,89%"
COLON,EL MANZANO,1129,1191,62,"5,49%"
COLON,GENERAL PAZ,1863,1973,110,"5,90%"
COLON,JESUS MARIA,28407,29710,1303,"4,59%"
COLON,JUAREZ CELMAN,9863,11360,1497,"15,18%"
COLON,LA PUERTA,347,349,2,"0,58%"
COLON,MALVINAS ARGENTINAS,11928,13138,1210,"10,14%"
COLON,MENDIOLAZA,9937,11529,1592,"16,02%"
COLON,MI GRANJA,915,1024,109,"11,91%"
COLON,RIO CEBALLOS,18297,19465,1168,"6,38%"
COLON,SALDAN,10787,12096,1309,"12,13%"
COLON,SALSIPUEDES,8733,9743,1010,"11,57%"
COLON,SANTA TERESA,63,59,-4,"-6,35%"
COLON,TINOCO,263,283,20,"7,60%"
COLON,UNQUILLO,16893,18018,1125,"6,66%"
COLON,VILLA ALLENDE,28954,30499,1545,"5,34%"
COLON,VILLA CERRO AZUL,363,382,19,"5,23%"
CRUZ DEL EJE,ALTO DE LOS QUEBRACHOS,430,388,-42,"-9,77%"
CRUZ DEL EJE,BAÑADO DE SOTO,711,722,11,"1,55%"
CRUZ DEL EJE,CANDELARIA,51,40,-11,"-21,57%"
CRUZ DEL EJE,CANTERAS QUILPO,95,78,-17,"-17,89%"
CRUZ DEL EJE,CRUZ DE CAÑA,227,218,-9,"-3,96%"
CRUZ DEL EJE,CRUZ DEL EJE,25016,26084,1068,"4,27%"
CRUZ DEL EJE,EL ABRA,45,43,-2,"-4,44%"
CRUZ DEL EJE,EL BRETE,1172,1414,242,"20,65%"
CRUZ DEL EJE,GUANACO MUERTO,958,932,-26,"-2,71%"
CRUZ DEL EJE,IGLESIA VIEJA,71,92,21,"29,58%"
CRUZ DEL EJE,LA BATEA,169,207,38,"22,49%"
CRUZ DEL EJE,LA HIGUERA,579,509,-70,"-12,09%"
CRUZ DEL EJE,LAS CAÑADAS,193,179,-14,"-7,25%"
CRUZ DEL EJE,LAS PLAYAS,618,754,136,"22,01%"
CRUZ DEL EJE,LOS CHAÑARITOS,769,802,33,"4,29%"
CRUZ DEL EJE,LOS LEONES,56,58,2,"3,57%"
CRUZ DEL EJE,LOS SAUCES,82,91,9,"10,98%"
CRUZ DEL EJE,MEDIA NARANJA,862,924,62,"7,19%"
CRUZ DEL EJE,PASO VIEJO,978,1035,57,"5,83%"
CRUZ DEL EJE,PICHANAS,159,147,-12,"-7,55%"
CRUZ DEL EJE,SAN ANTONIO,31,26,-5,"-16,13%"
CRUZ DEL EJE,SAN MARCOS SIERRAS,2333,2555,222,"9,52%"
CRUZ DEL EJE,SANTA ANA,86,75,-11,"-12,79%"
CRUZ DEL EJE,SERREZUELA,2662,2675,13,"0,49%"
CRUZ DEL EJE,SOTO,7152,7667,515,"7,20%"
CRUZ DEL EJE,TUCLAME,1219,1322,103,"8,45%"
GENERAL ROCA,BRUZONE,240,262,22,"9,17%"
GENERAL ROCA,BUCHARDO,1803,1777,-26,"-1,44%"
GENERAL ROCA,DEL CAMPILLO,3214,3192,-22,"-0,68%"
GENERAL ROCA,HUINCA RENANCO,7600,7565,-35,"-0,46%"
GENERAL ROCA,ITALO,1091,1068,-23,"-2,11%"
GENERAL ROCA,JOVITA,4281,4398,117,"2,73%"
GENERAL ROCA,LECUEDER,18,19,1,"5,56%"
GENERAL ROCA,MATTALDI,1633,1635,2,"0,12%"
GENERAL ROCA,ONAGOITY,67,64,-3,"-4,48%"
GENERAL ROCA,PINCEN,254,255,1,"0,39%"
GENERAL ROCA,RANQUELES,51,45,-6,"-11,76%"
GENERAL ROCA,VILLA HUIDOBRO,4969,5029,60,"1,21%"
GENERAL ROCA,VILLA SARMIENTO,308,297,-11,"-3,57%"
GENERAL ROCA,VILLA VALERIA,2687,2778,91,"3,39%"
GRAL SAN MARTIN,ARROYO ALGODON,1492,1521,29,"1,94%"
GRAL SAN MARTIN,ARROYO CABRAL,2890,2967,77,"2,66%"
GRAL SAN MARTIN,AUSONIA,946,977,31,"3,28%"
GRAL SAN MARTIN,CHAZON,994,1024,30,"3,02%"
GRAL SAN MARTIN,ETRURIA,3620,3719,99,"2,73%"
GRAL SAN MARTIN,LA LAGUNA,1355,1384,29,"2,14%"
GRAL SAN MARTIN,LA PLAYOSA,2848,2905,57,"2,00%"
GRAL SAN MARTIN,LUCA,588,587,-1,"-0,17%"
GRAL SAN MARTIN,MOJARRAS,68,61,-7,"-10,29%"
GRAL SAN MARTIN,PALESTINA,539,568,29,"5,38%"
GRAL SAN MARTIN,PASCO,1195,1248,53,"4,44%"
GRAL SAN MARTIN,SANABRIA,40,34,-6,"-15,00%"
GRAL SAN MARTIN,SILVIO PELLICO,630,633,3,"0,48%"
GRAL SAN MARTIN,TICINO,1998,2017,19,"0,95%"
GRAL SAN MARTIN,TIO PUJIO,3121,3192,71,"2,27%"
GRAL SAN MARTIN,VILLA MARIA,70985,72455,1470,"2,07%"
GRAL SAN MARTIN,VILLA NUEVA,17530,18740,1210,"6,90%"
ISCHILIN,AVELLANEDA,485,501,16,"3,30%"
ISCHILIN,CANTERAS,23,23,0,"0,00%"
ISCHILIN,CAÑADA DE RIO PINTO,398,376,-22,"-5,53%"
ISCHILIN,CHUÑA,593,601,8,"1,35%"
ISCHILIN,COPACABANA,347,357,10,"2,88%"
ISCHILIN,DEAN FUNES,18352,19296,944,"5,14%"
ISCHILIN,ISCHILIN,76,65,-11,"-14,47%"
ISCHILIN,JAIME PETER,55,59,4,"7,27%"
ISCHILIN,LOS POZOS,118,131,13,"11,02%"
ISCHILIN,OLIVARES SAN NICOLAS,571,579,8,"1,40%"
ISCHILIN,QUILINO ESTACION,4200,4210,10,"0,24%"
ISCHILIN,QUILINO VILLA,983,1189,206,"20,96%"
ISCHILIN,TOYOS,82,88,6,"7,32%"
ISCHILIN,VILLA GUTIERREZ,279,305,26,"9,32%"
JUAREZ CELMAN,ALEJANDRO,5040,5183,143,"2,84%"
JUAREZ CELMAN,ASSUNTA,74,94,20,"27,03%"
JUAREZ CELMAN,BENGOLEA,971,993,22,"2,27%"
JUAREZ CELMAN,CABRERA,10363,10534,171,"1,65%"
JUAREZ CELMAN,CARNERILLO,1884,1929,45,"2,39%"
JUAREZ CELMAN,CHARRAS,1041,1086,45,"4,32%"
JUAREZ CELMAN,DEHEZA,9509,9869,360,"3,79%"
JUAREZ CELMAN,EL RASTREADOR,60,74,14,"23,33%"
JUAREZ CELMAN,HUANCHILLA,1212,1176,-36,"-2,97%"
JUAREZ CELMAN,LA CARLOTA,10962,11183,221,"2,02%"
JUAREZ CELMAN,LOS CISNES,673,760,87,"12,93%"
JUAREZ CELMAN,OLAETA,644,656,12,"1,86%"
JUAREZ CELMAN,PACHECO DE MELO,72,84,12,"16,67%"
JUAREZ CELMAN,PASO DEL DURAZNO,110,122,12,"10,91%"
JUAREZ CELMAN,REDUCCION,1425,1497,72,"5,05%"
JUAREZ CELMAN,SANTA EUFEMIA,2122,2158,36,"1,70%"
JUAREZ CELMAN,UCACHA,4849,4951,102,"2,10%"
MARCOS JUAREZ,ALEJO LEDESMA,3106,3157,51,"1,64%"
MARCOS JUAREZ,ARIAS,6533,6509,-24,"-0,37%"
MARCOS JUAREZ,BALDISSERA,1992,1988,-4,"-0,20%"
MARCOS JUAREZ,BARGE,228,283,55,"24,12%"
MARCOS JUAREZ,CAMILO ALDAO,4149,4129,-20,"-0,48%"
MARCOS JUAREZ,CAP.B.O HIGGINS,320,317,-3,"-0,94%"
MARCOS JUAREZ,CAVANAGH,1056,1065,9,"0,85%"
MARCOS JUAREZ,CORRAL DE BUSTOS,8991,8971,-20,"-0,22%"
MARCOS JUAREZ,CRUZ ALTA,6295,6275,-20,"-0,32%"
MARCOS JUAREZ,GUATIMOZIN,2147,2108,-39,"-1,82%"
MARCOS JUAREZ,INRIVILLE,3487,3450,-37,"-1,06%"
MARCOS JUAREZ,ISLA VERDE,4118,4111,-7,"-0,17%"
MARCOS JUAREZ,LA ITALIANA,639,674,35,"5,48%"
MARCOS JUAREZ,LEONES,9334,9409,75,"0,80%"
MARCOS JUAREZ,LOS SURGENTES,2509,2477,-32,"-1,28%"
MARCOS JUAREZ,MARCOS JUAREZ,23149,23653,504,"2,18%"
MARCOS JUAREZ,MONTE BUEY,5441,5623,182,"3,34%"
MARCOS JUAREZ,ROCA,2587,2648,61,"2,36%"
MARCOS JUAREZ,SAIRA,755,762,7,"0,93%"
MARCOS JUAREZ,SALADILLO,136,141,5,"3,68%"
MARCOS JUAREZ,VILLA ELISA,26,32,6,"23,08%"
MINAS,AGUA DE RAMON,89,84,-5,"-5,62%"
MINAS,CIENAGA DEL CORO,926,946,20,"2,16%"
MINAS,EL CHACHO,158,161,3,"1,90%"
MINAS,ESTANCIA DE GUADALUPE,429,413,-16,"-3,73%"
MINAS,GUASAPAMPA,290,300,10,"3,45%"
MINAS,LA ARGENTINA,216,192,-24,"-11,11%"
MINAS,LA PLAYA,237,238,1,"0,42%"
MINAS,OJO DE AGUA DE TOTOX,89,91,2,"2,25%"
MINAS,PIEDRITA BLANCA,61,60,-1,"-1,64%"
MINAS,RUMIACO,27,23,-4,"-14,81%"
MINAS,RUMIHUASI,101,103,2,"1,98%"
MINAS,SAN CARLOS,2028,2103,75,"3,70%"
MINAS,TALAINI,152,145,-7,"-4,61%"
MINAS,TOSNO,186,189,3,"1,61%"
POCHO,CHANCANI,1010,1015,5,"0,50%"
POCHO,EL MEDANITO,64,68,4,"6,25%"
POCHO,LAS JARILLAS,93,91,-2,"-2,15%"
POCHO,LAS PALMAS,254,257,3,"1,18%"
POCHO,LOS TALARES,141,140,-1,"-0,71%"
POCHO,POCHO,499,488,-11,"-2,20%"
POCHO,SALSACATE,1978,1982,4,"0,20%"
POCHO,SAN JERONIMO,290,274,-16,"-5,52%"
POCHO,TALA CAÑADA,283,302,19,"6,71%"
PUNILLA,BIALET MASSE,5554,6163,609,"10,97%"
PUNILLA,CABALANGO,440,585,145,"32,95%"
PUNILLA,CAPILLA DEL MONTE,10340,10721,381,"3,68%"
PUNILLA,CASA GRANDE,643,763,120,"18,66%"
PUNILLA,CHARBONIER,658,704,46,"6,99%"
PUNILLA,COSQUIN,19042,19887,845,"4,44%"
PUNILLA,CUESTA BLANCA,425,477,52,"12,24%"
PUNILLA,ESTANCIA VIEJA,1038,1300,262,"25,24%"
PUNILLA,HUERTA GRANDE,5650,6037,387,"6,85%"
PUNILLA,LA CUMBRE,7039,7126,87,"1,24%"
PUNILLA,LA FALDA,13848,14079,231,"1,67%"
PUNILLA,LOS COCOS,1022,1018,-4,"-0,39%"
PUNILLA,MAYU SUMAJ,1115,1244,129,"11,57%"
PUNILLA,SAN ANTONIO DE ARREDONDO,4474,4750,276,"6,17%"
PUNILLA,SAN ESTEBAN,753,805,52,"6,91%"
PUNILLA,SAN ROQUE,1103,1293,190,"17,23%"
PUNILLA,SANTA MARIA,8095,8666,571,"7,05%"
PUNILLA,TALA HUASI,235,232,-3,"-1,28%"
PUNILLA,TANTI,5927,6518,591,"9,97%"
PUNILLA,VALLE HERMOSO,5416,5671,255,"4,71%"
PUNILLA,VILLA CARLOS PAZ,54764,56431,1667,"3,04%"
PUNILLA,VILLA GIARDINO,4997,5428,431,"8,63%"
PUNILLA,VILLA PARQUE SIQUIMAN,1746,2105,359,"20,56%"
PUNILLA,VILLA SANTA CRUZ DEL LAGO,2540,2881,341,"13,43%"
PUNILLA,YCHO CRUZ,1620,1802,182,"11,23%"
RIO CUARTO,ACHIRAS,2611,2680,69,"2,64%"
RIO CUARTO,ADELIA MARIA,6341,6453,112,"1,77%"
RIO CUARTO,ALCIRA,5508,5527,19,"0,34%"
RIO CUARTO,ALPA CORRAL,1215,1233,18,"1,48%"
RIO CUARTO,BAIGORRIA,1757,1816,59,"3,36%"
RIO CUARTO,BANDA NORTE,30030,30777,747,"2,49%"
RIO CUARTO,BERROTARAN,6347,6393,46,"0,72%"
RIO CUARTO,BULNES,1083,1056,-27,"-2,49%"
RIO CUARTO,CHAJAN,827,801,-26,"-3,14%"
RIO CUARTO,CHUCUL,413,431,18,"4,36%"
RIO CUARTO,ELENA,2865,2891,26,"0,91%"
RIO CUARTO,ESPINILLO,153,163,10,"6,54%"
RIO CUARTO,HOLMBERG,4707,5333,626,"13,30%"
RIO CUARTO,LA ARGENTINA,17,9,-8,"-47,06%"
RIO CUARTO,LA CAROLINA,243,251,8,"3,29%"
RIO CUARTO,LA CAUTIVA,736,782,46,"6,25%"
RIO CUARTO,LA GILDA,73,80,7,"9,59%"
RIO CUARTO,LA INVERNADA,71,74,3,"4,23%"
RIO CUARTO,LAS ACEQUIAS,2569,2638,69,"2,69%"
RIO CUARTO,LAS ALBAHACAS,440,463,23,"5,23%"
RIO CUARTO,LAS CAÑITAS,49,71,22,"44,90%"
RIO CUARTO,LAS HIGUERAS,6209,6992,783,"12,61%"
RIO CUARTO,LAS PEÑAS,215,206,-9,"-4,19%"
RIO CUARTO,LAS VERTIENTES,908,931,23,"2,53%"
RIO CUARTO,LOS CUATRO VIENTOS,168,175,7,"4,17%"
RIO CUARTO,MALENA,308,318,10,"3,25%"
RIO CUARTO,MOLDES,8120,8195,75,"0,92%"
RIO CUARTO,MONTE DE LOS GAUCHOS,686,717,31,"4,52%"
RIO CUARTO,PUEBLO ALBERDI,25649,26548,899,"3,51%"
RIO CUARTO,PUEYRREDON,103,111,8,"7,77%"
RIO CUARTO,RIO CUARTO,77167,76969,-198,"-0,26%"
RIO CUARTO,SAMPACHO,7443,7525,82,"1,10%"
RIO CUARTO,SAN AMBROSIO,128,125,-3,"-2,34%"
RIO CUARTO,SAN BASILIO,3266,3392,126,"3,86%"
RIO CUARTO,SUCO,477,473,-4,"-0,84%"
RIO CUARTO,TOSQUITA,526,552,26,"4,94%"
RIO CUARTO,VICUÑA MACKENNA,9141,9389,248,"2,71%"
RIO CUARTO,VILLA EL CHACAY,126,137,11,"8,73%"
RIO CUARTO,WASHINGTON,556,563,7,"1,26%"
RIO PRIMERO,ATAHONA,166,165,-1,"-0,60%"
RIO PRIMERO,BLAS DE ROSALES,106,92,-14,"-13,21%"
RIO PRIMERO,CAÑADA DE MACHADO,229,219,-10,"-4,37%"
RIO PRIMERO,CAPILLA DE REMEDIOS,1065,1075,10,"0,94%"
RIO PRIMERO,CHALACEA,230,239,9,"3,91%"
RIO PRIMERO,COLONIA LAS CUATRO ESQUINAS,114,122,8,"7,02%"
RIO PRIMERO,COMECHINGONES,311,310,-1,"-0,32%"
RIO PRIMERO,DIEGO DE ROJAS,503,508,5,"0,99%"
RIO PRIMERO,EL ALCALDE,116,110,-6,"-5,17%"
RIO PRIMERO,EL CRISPIN,253,268,15,"5,93%"
RIO PRIMERO,ESQUINA,341,327,-14,"-4,11%"
RIO PRIMERO,LA PARA,3669,3769,100,"2,73%"
RIO PRIMERO,LA POSTA,337,345,8,"2,37%"
RIO PRIMERO,LA PUERTA,2012,2102,90,"4,47%"
RIO PRIMERO,LA QUINTA,255,229,-26,"-10,20%"
RIO PRIMERO,LAS GRAMILLAS,137,142,5,"3,65%"
RIO PRIMERO,LAS HERAS,61,57,-4,"-6,56%"
RIO PRIMERO,LAS SALADAS,257,258,1,"0,39%"
RIO PRIMERO,MAQUINISTA GALLINI,182,164,-18,"-9,89%"
RIO PRIMERO,MONTE CRISTO,9441,10150,709,"7,51%"
RIO PRIMERO,MONTE DEL ROSARIO,146,131,-15,"-10,27%"
RIO PRIMERO,OBISPO TREJO,2407,2467,60,"2,49%"
RIO PRIMERO,PEDRO E.VIVAS,352,363,11,"3,13%"
RIO PRIMERO,PIQUILLIN,1676,1699,23,"1,37%"
RIO PRIMERO,PLAZA DE MERCEDES,140,126,-14,"-10,00%"
RIO PRIMERO,PUNTA DEL AGUA,38,37,-1,"-2,63%"
RIO PRIMERO,QUEBRACHO,93,85,-8,"-8,60%"
RIO PRIMERO,RIO PRIMERO,6644,6965,321,"4,83%"
RIO PRIMERO,SAGRADA FAMILIA,181,175,-6,"-3,31%"
RIO PRIMERO,VILLA FONTANA,911,933,22,"2,41%"
RIO PRIMERO,VILLA SANTA ROSA,7267,7465,198,"2,72%"
RIO SECO,CANDELARIA NORTE,764,825,61,"7,98%"
RIO SECO,CERRO COLORADO,339,351,12,"3,54%"
RIO SECO,CHAÑAR VIEJO,207,204,-3,"-1,45%"
RIO SECO,ENCRUCIJADA,42,43,1,"2,38%"
RIO SECO,EUFRASIO LOZA,205,205,0,"0,00%"
RIO SECO,GUTEMBERG,860,898,38,"4,42%"
RIO SECO,LA CAÑADA,89,85,-4,"-4,49%"
RIO SECO,LOS HOYOS,453,447,-6,"-1,32%"
RIO SECO,PUESTO DE CASTRO,439,405,-34,"-7,74%"
RIO SECO,RAYO CORTADO,700,743,43,"6,14%"
RIO SECO,RINCONADA,466,463,-3,"-0,64%"
RIO SECO,SANTA ELENA,346,350,4,"1,16%"
RIO SECO,SEBASTIAN ELCANO,2514,2589,75,"2,98%"
RIO SECO,VILLA DE MARIA,4823,5088,265,"5,49%"
RIO SEGUNDO,CALCHIN,2150,2211,61,"2,84%"
RIO SEGUNDO,CALCHIN OESTE,668,668,0,"0,00%"
RIO SEGUNDO,CAÑADA DE MACHADO SUD,17,8,-9,"-52,94%"
RIO SEGUNDO,CAPILLA DEL CARMEN,364,391,27,"7,42%"
RIO SEGUNDO,CARRILOBO,1705,1735,30,"1,76%"
RIO SEGUNDO,COLAZO,1373,1377,4,"0,29%"
RIO SEGUNDO,COLONIA VIDELA,45,47,2,"4,44%"
RIO SEGUNDO,COSTA SACATE,1377,1386,9,"0,65%"
RIO SEGUNDO,LAGUNA LARGA,6824,6806,-18,"-0,26%"
RIO SEGUNDO,LAS JUNTURAS,1545,1552,7,"0,45%"
RIO SEGUNDO,LOS CHAÑARITOS,278,292,14,"5,04%"
RIO SEGUNDO,LUQUE,5555,5751,196,"3,53%"
RIO SEGUNDO,MANFREDI,918,941,23,"2,51%"
RIO SEGUNDO,MATORRALES,956,973,17,"1,78%"
RIO SEGUNDO,ONCATIVO,11976,12193,217,"1,81%"
RIO SEGUNDO,PILAR,12441,13127,686,"5,51%"
RIO SEGUNDO,POZO DEL MOLLE,5578,5585,7,"0,13%"
RIO SEGUNDO,PUEBLO LUDUEÑA,189,197,8,"4,23%"
RIO SEGUNDO,RINCON,446,469,23,"5,16%"
RIO SEGUNDO,RIO SEGUNDO,17700,18052,352,"1,99%"
RIO SEGUNDO,SANTIAGO TEMPLE,2425,2448,23,"0,95%"
RIO SEGUNDO,VILLA DEL ROSARIO,13005,13476,471,"3,62%"
ROQUE SAENZ PEÑA,LA CESIRA,1399,1433,34,"2,43%"
ROQUE SAENZ PEÑA,LABOULAYE,18058,18335,277,"1,53%"
ROQUE SAENZ PEÑA,LEGUIZAMON,120,139,19,"15,83%"
ROQUE SAENZ PEÑA,LEVALLE,5066,5116,50,"0,99%"
ROQUE SAENZ PEÑA,MELO,1147,1150,3,"0,26%"
ROQUE SAENZ PEÑA,RIO BAMBA,99,101,2,"2,02%"
ROQUE SAENZ PEÑA,ROSALES,540,545,5,"0,93%"
ROQUE SAENZ PEÑA,SAN JOAQUIN,146,146,0,"0,00%"
ROQUE SAENZ PEÑA,SERRANO,3034,3072,38,"1,25%"
ROQUE SAENZ PEÑA,VILLA ROSSI,568,581,13,"2,29%"
SAN ALBERTO,ALTAUTINA,21,19,-2,"-9,52%"
SAN ALBERTO,AMBUL,944,1022,78,"8,26%"
SAN ALBERTO,ARROYO DE LOS PATOS,610,713,103,"16,89%"
SAN ALBERTO,BROCHERO,5650,5979,329,"5,82%"
SAN ALBERTO,EL VOLCAN,35,37,2,"5,71%"
SAN ALBERTO,LA CORTADERA,82,78,-4,"-4,88%"
SAN ALBERTO,LAS CALLES,506,535,29,"5,73%"
SAN ALBERTO,LAS RABONAS,717,779,62,"8,65%"
SAN ALBERTO,LOS CERROS,20,24,4,"20,00%"
SAN ALBERTO,LOS ESPINILLOS,223,253,30,"13,45%"
SAN ALBERTO,MINA CLAVERO,8252,8822,570,"6,91%"
SAN ALBERTO,NONO,2381,2462,81,"3,40%"
SAN ALBERTO,PAMPA DE ACHALA,122,142,20,"16,39%"
SAN ALBERTO,PANAHOLMA,396,399,3,"0,76%"
SAN ALBERTO,SAN LORENZO,961,1053,92,"9,57%"
SAN ALBERTO,SAN PEDRO,4175,4588,413,"9,89%"
SAN ALBERTO,SAN RAFAEL,158,150,-8,"-5,06%"
SAN ALBERTO,SAN VICENTE,1404,1432,28,"1,99%"
SAN ALBERTO,SAUCE ARRIBA,797,865,68,"8,53%"
SAN ALBERTO,VILLA BENEGAS,48,48,0,"0,00%"
SAN ALBERTO,VILLA SARMIENTO,4457,4694,237,"5,32%"
SAN JAVIER,CONLARA,401,430,29,"7,23%"
SAN JAVIER,DOLORES,27232,28139,907,"3,33%"
SAN JAVIER,EL MANANTIAL,29,34,5,"17,24%"
SAN JAVIER,LA PAZ,2852,3062,210,"7,36%"
SAN JAVIER,LA POBLACION,459,503,44,"9,59%"
SAN JAVIER,LAS ROSAS,4364,4780,416,"9,53%"
SAN JAVIER,LAS TAPIAS,1523,1648,125,"8,21%"
SAN JAVIER,LOS CERRILLOS,2021,2299,278,"13,76%"
SAN JAVIER,LOS HORNILLOS,1169,1283,114,"9,75%"
SAN JAVIER,LUYABA,1208,1298,90,"7,45%"
SAN JAVIER,QUEBRACHO LADEADO,254,398,144,"56,69%"
SAN JAVIER,SAN JAVIER,724,841,117,"16,16%"
SAN JAVIER,SAN JOSE,2119,2206,87,"4,11%"
SAN JAVIER,YACANTO,1177,1236,59,"5,01%"
SAN JUSTO,ALICIA,3015,2927,-88,"-2,92%"
SAN JUSTO,ALTOS DE CHIPION,1853,1886,33,"1,78%"
SAN JUSTO,ARROYITO,19673,20379,706,"3,59%"
SAN JUSTO,BALNEARIA,5618,5721,103,"1,83%"
SAN JUSTO,BEIRO,155,192,37,"23,87%"
SAN JUSTO,BRINKMANN,8482,8759,277,"3,27%"
SAN JUSTO,COLONIA ANITA,79,78,-1,"-1,27%"
SAN JUSTO,COLONIA PICHANAS,170,182,12,"7,06%"
SAN JUSTO,COLONIA VALTELINA,182,171,-11,"-6,04%"
SAN JUSTO,CONCEPCION,1767,1826,59,"3,34%"
SAN JUSTO,DEVOTO,5509,5611,102,"1,85%"
SAN JUSTO,DIEZ DE JULIO,151,182,31,"20,53%"
SAN JUSTO,DOS HERMANOS,125,144,19,"15,20%"
SAN JUSTO,EL ARAÑADO,1965,1956,-9,"-0,46%"
SAN JUSTO,EL FORTIN,1212,1206,-6,"-0,50%"
SAN JUSTO,EL FUERTECITO,373,375,2,"0,54%"
SAN JUSTO,EL TIO,1850,1901,51,"2,76%"
SAN JUSTO,FREYRE,6152,6151,-1,"-0,02%"
SAN JUSTO,ITURRASPE,112,112,0,"0,00%"
SAN JUSTO,LA FRANCIA,3530,3581,51,"1,44%"
SAN JUSTO,LA PAQUITA,987,1018,31,"3,14%"
SAN JUSTO,LA TORDILLA,1566,1596,30,"1,92%"
SAN JUSTO,LAS VARAS,1177,1222,45,"3,82%"
SAN JUSTO,LAS VARILLAS,14687,14980,293,"1,99%"
SAN JUSTO,LASPIUR,2376,2386,10,"0,42%"
SAN JUSTO,LUXARDO,358,364,6,"1,68%"
SAN JUSTO,MARINA,1208,1183,-25,"-2,07%"
SAN JUSTO,MARULL,1757,1770,13,"0,74%"
SAN JUSTO,MAUNIER,113,134,21,"18,58%"
SAN JUSTO,MIRAMAR DE ANSENUZA,2081,2148,67,"3,22%"
SAN JUSTO,MORTEROS,15829,16673,844,"5,33%"
SAN JUSTO,PORTEÑA,4967,5155,188,"3,78%"
SAN JUSTO,PROSPERIDAD,553,548,-5,"-0,90%"
SAN JUSTO,QUEBRACHO HERRADO,653,658,5,"0,77%"
SAN JUSTO,SACANTA,2940,2984,44,"1,50%"
SAN JUSTO,SAN BARTOLOME,1549,1728,179,"11,56%"
SAN JUSTO,SAN FRANCISCO SECC. NORTE,27103,28054,951,"3,51%"
SAN JUSTO,SAN FRANCISCO SECC. SUR,27763,28395,632,"2,28%"
SAN JUSTO,SAN PEDRO,264,238,-26,"-9,85%"
SAN JUSTO,SAUZE,22,17,-5,"-22,73%"
SAN JUSTO,SEEBER,659,706,47,"7,13%"
SAN JUSTO,TORO PUJIO,252,291,39,"15,48%"
SAN JUSTO,TRANSITO,3044,3105,61,"2,00%"
SAN JUSTO,VIGNAUD,645,685,40,"6,20%"
SAN JUSTO,VILLA SAN ESTEBAN,189,194,5,"2,65%"
SANTA MARIA,ALTA GRACIA,41867,43769,1902,"4,54%"
SANTA MARIA,ANIZACATE,4043,4759,716,"17,71%"
SANTA MARIA,BAJO CHICO,298,324,26,"8,72%"
SANTA MARIA,BARRIO PRIMERO DE MAYO,1348,1730,382,"28,34%"
SANTA MARIA,BOUWER,1553,1601,48,"3,09%"
SANTA MARIA,BUENA VISTA,27,19,-8,"-29,63%"
SANTA MARIA,COSME,50,48,-2,"-4,00%"
SANTA MARIA,DESPEÑADEROS,5604,5951,347,"6,19%"
SANTA MARIA,FALDA DEL CARMEN,1266,1433,167,"13,19%"
SANTA MARIA,JOSE DE LA QUINTANA,514,578,64,"12,45%"
SANTA MARIA,LA PAISANITA,165,173,8,"4,85%"
SANTA MARIA,LA RANCHERITA,159,167,8,"5,03%"
SANTA MARIA,LA SERRANITA,427,471,44,"10,30%"
SANTA MARIA,LOS CEDROS,1136,1219,83,"7,31%"
SANTA MARIA,LOZADA,1414,1419,5,"0,35%"
SANTA MARIA,MALAGUEÑO,6972,7295,323,"4,63%"
SANTA MARIA,MONTE RALO,488,481,-7,"-1,43%"
SANTA MARIA,POTRERO DE GARAY,1241,1363,122,"9,83%"
SANTA MARIA,RAFAEL GARCIA,648,648,0,"0,00%"
SANTA MARIA,SAN CLEMENTE,185,201,16,"8,65%"
SANTA MARIA,SAN ISIDRO,623,650,27,"4,33%"
SANTA MARIA,SAN NICOLAS,1744,2461,717,"41,11%"
SANTA MARIA,TOLEDO,4299,4742,443,"10,30%"
SANTA MARIA,VALLE DE ANIZACATE,793,1040,247,"31,15%"
SANTA MARIA,VILLA CIUDAD DE AMERICA,744,850,106,"14,25%"
SANTA MARIA,VILLA EL PRADO,1365,1717,352,"25,79%"
SANTA MARIA,VILLA LA BOLSA,974,1103,129,"13,24%"
SANTA MARIA,VILLA LOS AROMOS,850,956,106,"12,47%"
SANTA MARIA,VILLA PARQUE SANTA ANA,2572,2999,427,"16,60%"
SANTA MARIA,YOCSINA,2634,2991,357,"13,55%"
SOBREMONTE,CAMINIAGA,453,442,-11,"-2,43%"
SOBREMONTE,CHAÑAR,2548,2733,185,"7,26%"
SOBREMONTE,CHUÑAHUASI,344,337,-7,"-2,03%"
SOBREMONTE,POZO NUEVO,561,547,-14,"-2,50%"
TERCERO ARRIBA,ALMAFUERTE,10335,10624,289,"2,80%"
TERCERO ARRIBA,ASCASUBI,2264,2309,45,"1,99%"
TERCERO ARRIBA,CNIA ALMADA,565,562,-3,"-0,53%"
TERCERO ARRIBA,CORRALITO,1673,1695,22,"1,32%"
TERCERO ARRIBA,DALMACIO VELEZ,1407,1455,48,"3,41%"
TERCERO ARRIBA,GENERAL FOTHERINGHAM,352,340,-12,"-3,41%"
TERCERO ARRIBA,HERNANDO,9882,10077,195,"1,97%"
TERCERO ARRIBA,JAMES CRAIK,4581,4627,46,"1,00%"
TERCERO ARRIBA,LAS ISLETILLAS,262,260,-2,"-0,76%"
TERCERO ARRIBA,LAS PERDICES,4278,4401,123,"2,88%"
TERCERO ARRIBA,LOS ZORROS,603,621,18,"2,99%"
TERCERO ARRIBA,OLIVA,11264,11354,90,"0,80%"
TERCERO ARRIBA,PAMPAYASTA NORTE,425,424,-1,"-0,24%"
TERCERO ARRIBA,PAMPAYASTA SUD,1271,1274,3,"0,24%"
TERCERO ARRIBA,PUNTA DEL AGUA,227,226,-1,"-0,44%"
TERCERO ARRIBA,RIO TERCERO,41933,42845,912,"2,17%"
TERCERO ARRIBA,TANCACHA,4818,4912,94,"1,95%"
TOTORAL,CANDELARIA,400,390,-10,"-2,50%"
TOTORAL,CAÑADA DE LUQUE,1185,1188,3,"0,25%"
TOTORAL,LA PAMPA,718,729,11,"1,53%"
TOTORAL,LAS PEÑAS,1673,1715,42,"2,51%"
TOTORAL,LOS MISTOLES,144,149,5,"3,47%"
TOTORAL,MACHA,76,65,-11,"-14,47%"
TOTORAL,SANTA CATALINA,234,251,17,"7,26%"
TOTORAL,SARMIENTO,1088,1145,57,"5,24%"
TOTORAL,SIMBOLAR,319,330,11,"3,45%"
TOTORAL,SINSACATE,1774,1995,221,"12,46%"
TOTORAL,SITON,626,653,27,"4,31%"
TOTORAL,VILLA DEL TOTORAL,7756,8031,275,"3,55%"
TULUMBA,CHURQUI CAÑADA,163,151,-12,"-7,36%"
TULUMBA,EL BAÑADO,39,34,-5,"-12,82%"
TULUMBA,EL RODEO,243,243,0,"0,00%"
TULUMBA,ISLA DE SAN ANTONIO,49,49,0,"0,00%"
TULUMBA,LA CAÑADA,28,27,-1,"-3,57%"
TULUMBA,LA DORMIDA,4459,4606,147,"3,30%"
TULUMBA,LA TOMA,115,146,31,"26,96%"
TULUMBA,LAS ARRIAS,2046,2035,-11,"-0,54%"
TULUMBA,LAS MASITAS,16,14,-2,"-12,50%"
TULUMBA,LUCIO V MANSILLA,1088,1055,-33,"-3,03%"
TULUMBA,ROSARIO DEL SALADILLO,493,451,-42,"-8,52%"
TULUMBA,SAN JOSE DE LAS SALINAS,648,654,6,"0,93%"
TULUMBA,SAN PEDRO NORTE,587,600,13,"2,21%"
TULUMBA,SANTA CRUZ,97,92,-5,"-5,15%"
TULUMBA,TULUMBA,1844,1899,55,"2,98%"
UNION,ALTO ALEGRE,1122,1144,22,"1,96%"
UNION,ANA ZUMARAN,175,202,27,"15,43%"
UNION,BALLESTEROS,3673,3868,195,"5,31%"
UNION,BALLESTEROS SUD,675,854,179,"26,52%"
UNION,BELL VILLE,30587,31325,738,"2,41%"
UNION,BISMARCK,415,420,5,"1,20%"
UNION,BREMEN,246,239,-7,"-2,85%"
UNION,CANALS,7708,7714,6,"0,08%"
UNION,CARCANO,17,23,6,"35,29%"
UNION,CHILIBROSTE,615,653,38,"6,18%"
UNION,CINTRA,1350,1421,71,"5,26%"
UNION,CORRAL DEL BAJO,13,7,-6,"-46,15%"
UNION,ESCALANTE,1367,1348,-19,"-1,39%"
UNION,GOULD,632,628,-4,"-0,63%"
UNION,IDIAZABAL,1470,1460,-10,"-0,68%"
UNION,LABORDE,5210,5244,34,"0,65%"
UNION,MONTE LEÑA,514,530,16,"3,11%"
UNION,MONTE MAIZ,6600,6525,-75,"-1,14%"
UNION,MORRISON,3317,3492,175,"5,28%"
UNION,NOETINGER,4558,4566,8,"0,18%"
UNION,ORDOÑEZ,2356,2381,25,"1,06%"
UNION,PASCANAS,2474,2458,-16,"-0,65%"
UNION,POSSE,7503,7678,175,"2,33%"
UNION,PUEBLO ITALIANO,1585,1594,9,"0,57%"
UNION,SAN ANTONIO,1446,1516,70,"4,84%"
UNION,SAN MARCOS SUD,2757,2823,66,"2,39%"
UNION,SANTA MARIA,204,226,22,"10,78%"
UNION,VIAMONTE,1574,1599,25,"1,59%"
UNION,VILLA LOS PATOS,43,34,-9,"-20,93%"
Total,Total,2783122,2884358,101236,"3,64%"